Secure Flash drive	secure_flash_drive
SSD drive	ssd_drive
Trijicon REAP-IR thermal riflescope	trijicon_reap-ir_thermal_riflescope
T-7 Thermal Goggles with Night Vision Mounts	t-7_thermal_goggles_with_night_vision_mounts
Purified water	purified_water
GPNVG-18 Night Vision	gpnvg-18_night_vision
T H I C C Weapon case	t_h_i_c_c_weapon_case
Lucky Scav Junkbox	lucky_scav_junkbox
Lab. Blue keycard	lab._blue_keycard
TerraGroup Labs access keycard	terragroup_labs_access_keycard
Money case	money_case
Red Rebel Ice pick	red_rebel_ice_pick
Ammo case	ammo_case
Folder with intelligence	folder_with_intelligence
Physical bitcoin	physical_bitcoin_(btc)
Documents case	documents_case
Meds case	meds_case
Bronze lion	bronze_lion
T H I C C Items case	t_h_i_c_c_items_case
Key to KIBA store outlet	key_to_kiba_store_outlet
"Fierce Hatchling" moonshine	fierce_hatchling_moonshine
Graphics card	graphics_card
Keytool	keytool
West wing room 219 key	west_wing_room_219_key
Corrugated hose	corrugated_hose
Small S I C C case	small_s_i_c_c_case
Magazine case	magazine_case
Lab. Yellow keycard	lab._yellow_keycard
Factory exit key	factory_exit_key
Lab. Violet keycard	lab._violet_keycard
East wing room 226 key	east_wing_room_226_key
Car battery	car_battery
FP-100 filter absorber	fp-100_filter_absorber
6-STEN-140-M military battery	6-sten-140-m_military_battery
Lab. Black keycard	lab._black_keycard
LEDX Skin Transilluminator	ledx_skin_transilluminator
Lab. Green keycard	lab._green_keycard
Lab. Red keycard	lab._red_keycard
RB-RH key	RB-RH_key
RB-ST key	RB-ST_key
Key RB-PSP2	RB-PSP2_Key
RB-SMP key	RB-SMP_key
RB-KSM key	RB-KSM_key
RB-KORL key	RB-KORL_key
RB-ORB3 key	RB-ORB3_key
RB-PP key	RB-PP_key
RB-PSP1 key	RB-PSP1_key
RB-MP22 key	RB-MP22_key
RB-MP21 key	RB-MP21_key
RB-MP13 key	RB-MP13_key
RB-MP11 key	RB-MP11_key
RB-AM key	RB-AM_key
RB-OB key	RB-OB_key
RB-VO key	RB-VO_key
RB-BK key	RB-BK_key
Key to EMERCOM medical unit	Key_to_EMERCOM_medical_unit
RB-KPRL key	RB-KPRL_key
East wing room 314 key	East_wing_room_314_key
East wing room 313 key	East_wing_room_313_key
East wing room 306 key	East_wing_room_306_key
East wing room 206 key	East_wing_room_206_key
East wing room 205 key	East_wing_room_205_key
Office 107 East wing key	Office_107_East_wing_key
East wing room 308 key	East_wing_room_308_key
West wing room 306 key	West_wing_room_306_key
West wing room 301 key	West_wing_room_301_key
West wing room 222 key	West_wing_room_222_key
West wing room 221 key	West_wing_room_221_key
West wing room 220 key	West_wing_room_220_key
RB-MP12 key	RB-MP12_key
RB-AK key	RB-AK_key
Machinery key	Machinery_key
RB-ORB2 key	RB-ORB2_key
Key to Goshan cash register	Key_to_Goshan_cash_register
RB-PS81 key	RB-PS81_key
East wing room 216 key	East_wing_room_216_key
RB-RS key	RB-RS_key
RB-TB key	RB-TB_key
Unknown key	Unknown_key
RB-OP key	RB-OP_key
East wing room 328 key	East_wing_room_328_key
RB-GN key	RB-GN_key
West wing room 216 key	West_wing_room_216_key
RB-ORB1 key	RB-ORB1_key
Marked key	Marked_key
East wing room 222 key	East_wing_room_222_key
Lab. key. Arsenal storage room	Lab._key._Arsenal_storage_room
RB-PS82 key	RB-PS82_key
Health resort management office safe key	Health_resort_management_office_safe_key
Shturman key	Shturman_key
Lab. key. Testing area (weap.)	Lab._key._Testing_area_(weap.)
Dorm room 203 Key	Dorm_room_203_Key
Dorm room 303 Key	Dorm_room_303_Key
West wing room 218 key	West_wing_room_218_key
Military base checkpoint key	Military_base_checkpoint_key
Customs office key	Customs_office_key
Portable cabin key of customs Factory zone	Portable_cabin_key_of_customs_Factory_zone
Trailer park cabin key	Trailer_park_cabin_key
RB-AO key	RB-AO_key
Health resort utility room key	Health_resort_utility_room_key
Office 104 West wing key	Office_104_West_wing_key
Lab. key. Manager office	Lab._key._Manager_office
Office 112 West wing key	Office_112_West_wing_key
Dorm guard desk key	Dorm_guard_desk_key
Dorm room 214 Key	Dorm_room_214_Key
Dorm room 114 Key	Dorm_room_114_Key
Dorm room 220 Key	Dorm_room_220_Key
Dorm room 104 Key	Dorm_room_104_Key
Dorm room 206 Key	Dorm_room_206_Key
NIXXOR lens	NIXXOR_lens
Metal cutting scissors	Metal_cutting_scissors
Chain with Prokill medallion	Chain_with_Prokill_medallion
Tetriz portable game	Tetriz_portable_game
Deadlyslob's beard oil	Deadlyslob's_beard_oil
Roler submariner gold wrist watch	Roler_submariner_gold_wrist_watch
42nd Signature Blend English Tea	42nd_Signature_Blend_English_Tea
Powerbank	Powerbank
Ophthalmoscope	Ophthalmoscope
Dry fuel	Dry_fuel
Heat-exchange alkali surface washer	Heat-exchange_alkali_surface_washer
5L propane tank	5L_propane_tank
Medical bloodset	Medical_bloodset
Shustrilo sealing foam	Shustrilo_sealing_foam
Clin wiper	Clin_wiper
Magnet	Magnet
Soap	Soap
Golden neck chain	Golden_neck_chain
Chainlet	Chainlet
Silver Badge	Silver_Badge
Pliers	Pliers
Wrench	Wrench
Screwdriver	Screwdriver
Printer paper	Printer_paper
T-Shaped Plug	T-Shaped_Plug
USB Adapter	USB_Adapter
Toothpaste	Toothpaste
Construction measuring tape	Construction_measuring_tape
Duct tape	Duct_tape
Powercord	Powercord
RAM	RAM
PC CPU	PC_CPU
CPU Fan	CPU_Fan
Broken GPhone	Broken_GPhone
Ultraviolet lamp	Ultraviolet_lamp
D Size Battery	D_Size_Battery
AA Battery	AA_Battery
Broken GPhone X	Broken_GPhone_X
Capacitors	Capacitors
Gas analyzer	Gas_analyzer
Wooden clock	Wooden_clock
Cat figurine	Cat_figurine
Strike Cigarettes	Strike_Cigarettes
Energy-saving lamp	Energy-saving_lamp
Zibbo lighter	Zibbo_lighter
Bolts	Bolts
Screw nut	Screw_nut
Expeditionary fuel tank	Expeditionary_fuel_tank
Paracord	Paracord
Dogtag USEC	Dogtag_USEC
Dogtag BEAR	Dogtag_BEAR
A pack of nails	A_pack_of_nails
Key to KIBA Outlet grate door	Key_to_KIBA_Outlet_grate_door
Key to pharmacy	Key_to_pharmacy
Key to utility room of power substation	Key_to_utility_room_of_power_substation
Key to utility room of OLI outlet	Key_to_utility_room_of_OLI_outlet
Key to OLI administrator office	Key_to_OLI_administrator_office
East wing room 310 key	East_wing_room_310_key
West wing room 325 key	West_wing_room_325_key
West wing room 303 key	West_wing_room_303_key
Maska 1Sch face shield (Killa)	Maska_1Sch_face_shield_(Killa)
Altyn face shield	Altyn_face_shield
Kiver face shield	Kiver_face_shield
Nippers	Nippers
West wing room 309 key	West_wing_room_309_key
Adrenaline injector	Adrenaline_injector
Combat stimulant injector SJ6 TGLabs	Combat_stimulant_injector_SJ6_TGLabs
CMS kit	CMS_kit
Golden Star Balm	Golden_Star_Balm
Vaseline	Vaseline
Grizzly First Aid Kit	Grizzly_First_Aid_Kit
West wing room 323 key	West_wing_room_323_key
IFAK personal tactical first aid kit	IFAK_personal_tactical_first_aid_kit
Salewa FIRST AID KIT	Salewa_FIRST_AID_KIT
Car first aid kit	Car_first_aid_kit
Morphine injector	Morphine_injector
Augmentin antibiotic pills	Augmentin_antibiotic_pills
Bottle of vodka Tarkovskaya	Bottle_of_vodka_Tarkovskaya
Jar of DevilDog mayo	Jar_of_DevilDog_mayo
Hot Rod	Hot_Rod
TarCola	TarCola
Max energy	Max_energy
Hand drill	Handdrill
Bottle of Dan Jackiel Whiskey	Bottle_of_Dan_Jackiel_Whiskey
Vita juice	Vita_juice
Apple juice	Apple_juice
Insulating tape	Insulating_tape
Green Ice	Green_Ice
Russian Army pineapple juice	Russian_Army_pineapple_juice
0.6L water bottle	0.6L_water_bottle
Hemostatic drug Zagustin	Hemostatic_drug_Zagustin
MRE lunch box	MRE_lunch_box
Squash spread	Squash_spread
Can of green peas	Can_of_green_peas
Military COFDM wireless Signal Transmitter	Military_COFDM_wireless_Signal_Transmitter
Office 108 East wing key	Office_108_East_wing_key
Humpback salmon	Humpback_salmon
Emelya rye croutons	Emelya_rye_croutons
Pack of sugar	Pack_of_sugar
Slickers bar	Slickers_bar
SAS drive	SAS_drive
Alyonka chocolate bar	Alyonka_chocolate_bar
Army Crackers	Army_Crackers
Dogtag case	Dogtag_case
Empty Wallet	Wallet
Mr. Holodilnick thermobag	Mr._Holodilnick_thermobag
LSHZ-2DTM face shield	LSHZ-2DTM_face_shield
Weapon case	Weapon_case
Rechargeable battery	Rechargeable_battery
Slim diary	Slim_diary
Diary	Diary
Phase control relay	Phase_control_relay
Long flat screwdriver	Long_flat_screwdriver
Pistol case	Pistol_case
Radiator helix	Radiator_helix
Key to OLI cash register	Key_to_OLI_cash_register
Condensed milk	Condensed_milk
Key ZB-014	Key_ZB-014
Old firesteel	Old_firesteel
Coffee Majaica	Coffee_Majaica
Gold skull ring	Gold_skull_ring
Weather station safe key	Weather_station_safe_key
Broken LCD	Broken_LCD
Battered antique Book	Battered_antique_Book
Golden 1GPhone	Golden_1GPhone
Dorm room 105 Key	Dorm_room_105_Key
Air filter for gas mask	Air_filter_for_gas_mask
Rye croutons	Rye_croutons
Hydrogen peroxide	Hydrogen_peroxide
Antique teapot	Antique_teapot
Pliers Elite	Pliers_Elite
Portable defibrillator	Portable_defibrillator
A pack of screws	A_pack_of_screws
Silicone tube	Silicone_tube
FireKlean gun lube	FireKlean_gun_lube
Surv12 field surgical kit	Surv12_field_surgical_kit
Grand juice	Grand_juice
Xenomorph sealing foam	Xenomorph_sealing_foam
Combat stimulant injector SJ1 TGLabs	Combat_stimulant_injector_SJ1_TGLabs
Yotota car key	Yotota_car_key
Ortodontox toothpaste	Ortodontox_toothpaste
Can of delicious beef stew	Can_of_delicious_beef_stew
Can of herring	Can_of_herring
Classic matches	Matches
Can of beef stew	Can_of_beef_stew
Virtex programmable processor	Virtex_programmable_processor
Dorm room 315 Key	Dorm_room_315_Key
Vulkan-5 face shield	Vulkan-5_face_shield
Gunpowder "Eagle"	Gunpowder_"Eagle"
Cabinet key	Cabinet_key
Malboro Cigarettes	Malboro_Cigarettes
WD-40 100ml.	WD-40_100ml
Fuel conditioner	Fuel_conditioner
Apollon Soyuz cigarettes	Apollon_Soyuz_cigarettes
East wing room 322 key	East_wing_room_322_key
Dorm room 110 Key	Dorm_room_110_Key
Power supply unit	Power_supply_unit
Pile of meds	Pile_of_meds
Golden rooster	Golden_rooster
ZSh-1-2M face shield	ZSh-1-2M_face_shield
Phased array element	Phased_array_element
Key to IDEA cash register	Key_to_IDEA_cash_register
Key to OLI logistics department office	Key_to_OLI_logistics_department_office
Water bottle with a filter Aquamari	Water_bottle_with_a_filter_Aquamari
East wing room 213 key	East_wing_room_213_key
Damaged hard drive	Damaged_hard_drive
Printed circuit board	Printed_circuit_board
Gunpowder "Kite"	Gunpowder_"Kite"
Electric drill	Electric_drill
WD-40 400ml	WD-40_400ml
Schaman shampoo	Schaman_shampoo
Dorm room 204 Key	Dorm_room_204_Key
Military gyrotachometer	Military_gyrotachometer
Metal fuel tank	Metal_fuel_tank
Antique vase	Antique_vase
East wing room 209 key	East_wing_room_209_key
Pack of milk	Pack_of_milk
Iskra lunch box	Iskra_lunch_box
Working LCD	Working_LCD
Weapon parts	Weapon_parts
Military thermal vision module Iridium	Military_thermal_vision_module_Iridium
Paid AntiRoach	Paid_AntiRoach
UHF RFID Reader	UHF_RFID_Reader
Technical documentation	Technical_documentation
Key to HEP station storage	Key_to_HEP_station_storage
Light bulb	Light_bulb
Car key	Car_key
Pack of oat flakes	Pack_of_oat_flakes
West wing room 203 key	West_wing_room_203_key
West wing room 205 key	West_wing_room_205_key
Spark plug	Spark_plug
A set of tools	A_set_of_tools
Wilston cigarettes	Wilston_cigarettes
Horse figurine	Horse_figurine
Regenerative stimulant injector eTG-change	Regenerative_stimulant_injector_eTG-change
Dorm room 103 Key	Dorm_room_103_Key
Ox bleach	Ox_bleach
Dorm room 108 Key	Dorm_room_108_Key
Can of sprats	Can_of_sprats
Can of pacific saury	Can_of_pacific_saury
Dorm room 118 Key	Dorm_room_118_Key
Ibuprofen painkillers	Ibuprofen_painkillers
Dorm room 218 Key	Dorm_room_218_Key
Dorm room 306 Key	Dorm_room_306_Key
Portable cabin key	Portable_cabin_key
Geiger-Muller counter	Geiger-Muller_counter
VPX Flash Storage Module	VPX_Flash_Storage_Module
The key to the gas station storage room	The_key_to_the_gas_station_storage_room
Piece of plexiglas	Piece_of_plexiglas
East wing room 316 key	East_wing_room_316_key
Military cable	Military_cable
Health resort warehouse safe key	Health_resort_warehouse_safe_key
Wires	Wires
Key to store safe	Key_to_store_safe
Saline solution	Saline_solution
OFZ 30x160mm shell	OFZ_30x160mm_shell
Gas station safe key	Gas_station_safe_key
Cottage back entrance key	Cottage_back_entrance_key
Dorm room 308 Key	Dorm_room_308_Key
Gunpowder "Hawk"	Gunpowder_"Hawk"
Cottage safe key	Cottage_safe_key
SMW car key	SMW_car_key
Toilet paper	Toilet_paper
DVD drive	DVD_drive
Health resort room 321 safe key	Health_resort_room_321_safe_key
Multi-hit ballistic face shield-visor for Ops-Core FAST helmet	Multi-hit_ballistic_face_shield-visor_for_Ops-Core_FAST_helmet
Electric motor	Electric_motor
West wing room 207 key	West_wing_room_207_key
Water filter	Water_filter
Sodium bicarbonate	Sodium_bicarbonate
GP coin	GP_coin
Crickent lighter	Crickent_lighter
Propital	Propital
Disposable syringe	Disposable_syringe
Military circuit board	Military_circuit_board
Round pliers	Round_pliers
Military power filter	Military_power_filter
Pressure gauge	Pressure_gauge
Analog thermometer	Analog_thermometer
6x Scope	Valday_PS-320_1x_6x_Scope
Makeshift 7.62x25 TT silencer	Makeshift_7.62x25_ТТ_silencer
VSS 9x39 integral barrel-suppressor	VSS_9x39_integral_barrel-suppressor
AAC 762 SDN-6 7.62x51 Sound Suppressor	AAC_762_SDN-6_7.62x51_Sound_Suppressor
SilencerCo Salvo 12 sound suppressor	SilencerCo_Salvo_12_sound_suppressor
Regular SV-98 7.62x54 silencer	Regular_SV-98_7.62x54_silencer
Sig SRD 9 9x19mm sound suppressor	Sig_SRD_9_9x19mm_sound_suppressor
AAC Illusion 9 9x19mm silencer	AAC_Illusion_9_9x19mm_silencer
ASh-12 12.7x55 tactical suppressor	ASh-12_12.7x55_tactical_suppressor
FN Attenuator 5.7x28 silencer	FN_Attenuator_5.7x28_silencer
Daniel Defence Wave QD Sound Suppressor	Daniel_Defence_Wave_QD_Sound_Suppressor
Gemtech SFN-57 5.7x28mm silencer	Gemtech_SFN-57_5.7x28mm_silencer
B&T MP9 9x19mm sound suppressor	B&T_MP9_9x19mm_sound_suppressor
KAC PRS QDC 7.62x51 Sound Suppressor	KAC_PRS_QDC_7.62x51_Sound_Suppressor
Rotor 43 7.62x54 muzzle brake	Rotor_43_7.62x54_muzzle_brake
suppressor	TGP-A_5.45x39_muzzle_device_suppressor
Rotor 43 5.56x45 muzzle brake	Rotor_43_5.56x45_muzzle_brake
KAC QDSS NT-4 Black 5.56x45 silencer	KAC_QDSS_NT-4_Black_5.56x45_silencer
PP-91-01 Kedr-B 9x18PM suppressor	PP-91-01_Kedr-B_9x18PM_suppressor
Alpha Dog Alpha 9 9x19 sound suppressor	Alpha_Dog_Alpha_9_9x19_sound_suppressor
Hexagon AK-74 5.45x39 sound suppressor	Hexagon_AK-74_5.45x39_sound_suppressor
B&T Rotex 2 4.6x30 silencer	B&T_Rotex_2_4.6x30_silencer
PBS-4 5.45x39 Silencer	PBS-4_5.45x39_Silencer
Rotor 43 7.62x39 muzzle brake	Rotor_43_7.62x39_muzzle_brake
PBS-1 7.62x39 silencer	PBS-1_7.62x39_silencer
Stock silencer for PB 9x18 PM	Stock_silencer_for_PB_9x18_PM
Monstrum Compact prism scope 2x32	Monstrum_Compact_prism_scope_2x32
Trijicon ACOG 3.5x35 scope	Trijicon_ACOG_3.5x35_scope
Sig BRAVO4 4X30 Scope	Sig_BRAVO4_4X30_Scope
Primary Arms Compact prism scope 2.5x	Primary_Arms_Compact_prism_scope_2.5x
Leupold Mark 4 HAMR 4x24mm DeltaPoint hybrid assault scope	Leupold_Mark_4_HAMR_4x24mm_DeltaPoint_hybrid_assault_scope
4x Scope FDE	ELCAN_SpecterDR_1x_4x_Scope_FDE
Optical scope March Tactical 3-24x42 FFP	Optical_scope_March_Tactical_3-24x42_FFP
Leupold Mark 4 LR 6.5-20x50 riflescope	Leupold_Mark_4_LR_6.5-20x50_riflescope
PU 3.5x riflescope	PU_3.5x_riflescope
Burris FullField TAC 30 1-4x24 riflescope	Burris_FullField_TAC_30_1-4x24_riflescope
Zenit-Belomo PSO 1M2 4x24 scope	Zenit-Belomo_PSO_1M2_4x24_scope
NPZ USP-1 4x scope	NPZ_USP-1_4x_scope
KMZ 1P59 3-10x riflescope	KMZ_1P59_3-10x_riflescope
NcSTAR ADO P4 Sniper 3-9x42 riflescope	NcSTAR_ADO_P4_Sniper_3-9x42_riflescope
VOMZ Pilad 4x32 riflescope	VOMZ_Pilad_4х32_riflescope
PVS-14 Night Vision Monocular	AN_PVS-14_Night_Vision_Monocular
Armasight N-15 Night Vision	Armasight_N-15_Night_Vision
PNV-10T Night Vision	PNV-10T_Night_Vision
Vulcan MG night scope 3.5x	Vulcan_MG_night_scope_3.5x
Trijicon ACOG TA01NSN 4x32 scope TAN	Trijicon_ACOG_TA01NSN_4x32_scope_TAN
FN Ring sight reflex sight	FN_Ring_sight_reflex_sight
Eotech XPS3-2 holographic sight	Eotech_XPS3-2_holographic_sight
Vortex Razor AMG UH-1 holographic sight	Vortex_Razor_AMG_UH-1_holographic_sight
Eotech EXPS3 holographic sight	Eotech_EXPS3_holographic_sight
Rotor 43 9x19 muzzle brake	Rotor_43_9x19_muzzle_brake
Holosun HS401G5 reflex sight	Holosun_HS401G5_reflex_sight
Eotech XPS3-0 holographic sight	Eotech_XPS3-0_holographic_sight
SR1MP silencer 9x21	SR1MP_silencer_9x21
VOMZ Pilad P1X42 "WEAVER" reflex sight	VOMZ_Pilad_P1X42_"WEAVER"_reflex_sight
Eotech 553 holographic sight	Eotech_553_holographic_sight
Cobra EKP-8-18 reflex sight	Cobra_EKP-8-18_reflex_sight
Aimpoint COMP M4 reflex sight	Aimpoint_COMP_M4_reflex_sight
Trijicon SRS-02 reflex sight	Trijicon_SRS-02_reflex_sight
VKBO army bag	VKBO_army_bag
Tactical sling bag	Tactical_sling_bag
Tactical fleece hat	Tactical_fleece_hat
Zenit-Belomo PSO 1 4x24 scope	Zenit-Belomo_PSO_1_4x24_scope
Ski hat with holes for eyes	Ski_hat_with_holes_for_eyes
Santa's hat	Santa's_hat
PSH-97 "Djeta" helmet	PSH-97_"Djeta"_helmet
Pompon hat	Pompon_hat
Miltec panama hat	Miltec_panama_hat
Kotton beanie	Kotton_beanie
Kinda cowboy hat	Kinda_cowboy_hat
EmerCom cap	EmerCom_cap
Ded Moroz hat	Ded_Moroz_hat
Beanie	Beanie
"Door Kicker" Boonie hat	"Door_Kicker"_Boonie_hat
Slender mask	Slender_mask
Shemagh (var. 2)	Shemagh_(var._2)
Momex balaclava	Momex_balaclava
Army cap	Army_cap
Misha Mayorov's mask	Misha_Mayorov's_mask
Jason mask	Jason_mask
GP-5 gasmask	GP-5_gasmask
Ghost balaclava	Ghost_balaclava
Fake white beard	Fake_white_beard
Cold Fear Infrared balaclava	Cold_Fear_Infrared_balaclava
Balaclava	Balaclava
Wartech TV-110 plate carrier	Wartech_TV-110_plate_carrier
Crye Precision AVS platecarrier	Crye_Precision_AVS_platecarrier
ANA Tactical M2 armored rig	ANA_Tactical_M2_armored_rig
ANA Tactical M1 armored rig	ANA_Tactical_M1_armored_rig
6B5-15 Zh -86 "Uley" armored rig	6B5-15_Zh_-86_"Uley"_armored_rig
5.11 Tactec plate carrier	5.11_Tactec_plate_carrier
Wartech MK3 chest rig (TV-104)	Wartech_MK3_chest_rig_(TV-104)
EOtech Vudu 1-6 riflescope	EOtech_Vudu_1-6_riflescope
Velocity Systems Multi-Purpose Patrol Vest	Velocity_Systems_Multi-Purpose_Patrol_Vest
Blackhawk! Commando Chest Harness	Blackhawk!_Commando_Chest_Harness
Trijicon RMR	Trijicon_RMR
Belt-A + Belt-B gear rig	Belt-A_ _Belt-B_gear_rig
Scav Vest	Scav_Vest
Peltor Tactical Sport headset	Peltor_Tactical_Sport_headset
GSSh-01 active headset	GSSh-01_active_headset
Peltor ComTac 2 headset	Peltor_ComTac_2_headset
L active headphones	MSA_Sordin_Supreme_PRO-X_L_active_headphones
Ops-Core FAST RAC Headset	Ops-Core_FAST_RAC_Headset
ZSh-1-2M helmet (black)	ZSh-1-2M_helmet_(black)
6B47 Ratnik-BSh Helmet	6B47_Ratnik-BSh_Helmet
AS VAL 9x39 integral barrel-suppressor	AS_VAL_9x39_integral_barrel-suppressor
Fischer Development FD917 suppressor	Fischer_Development_FD917_suppressor
Hexagon SKS 7.62x39 sound suppressor	Hexagon_SKS_7.62x39_sound_suppressor
Police cap	Police_cap
ANA Tactical Alpha chest rig	ANA_Tactical_Alpha_chest_rig
Pilgrim tourist backpack	Pilgrim_tourist_backpack
Ushanka ear-flap cap	Ushanka_ear-flap_cap
Baseball cap	Baseball_cap
BNTI Kirasa-N armor	BNTI_Kirasa-N_armor
Haley Strategic D3CRX Chest Harness	Haley_Strategic_D3CRX_Chest_Harness
SSh-68 helmet (1968 steel helmet)	SSh-68_helmet_(1968_steel_helmet)
SOE Micro Rig	SOE_Micro_Rig
OKP-7 reflex sight (Dovetail)	OKP-7_reflex_sight_(Dovetail)
Soft tank crew helmet TSH-4M-L	Soft_tank_crew_helmet_TSH-4M-L
KAC QDSS NT-4 FDE 5.56x45 silencer	KAC_QDSS_NT-4_FDE_5.56x45_silencer
Hensoldt FF 4-16x56 scope	Hensoldt_FF_4-16x56_scope
Triton M43-A Chest Harness	Triton_M43-A_Chest_Harness
Rotor 43 .366TKM muzzle brake	Rotor_43_.366TKM_muzzle_brake
Blackhawk! Commando Chest Harness (black)	Blackhawk!_Commando_Chest_Harness_(black)
Jack-o'-lantern tactical pumpkin helmet	Jack-o'-lantern_tactical_pumpkin_helmet
Crye Precision Airframe Tan	Crye_Precision_Airframe_Tan
Fake mustache	Fake_mustache
Zenit DTK-4M muzzle brake	Zenit_DTK-4М_muzzle_brake
FORT Redut-T5 body armor	FORT_Redut-T5_body_armor
Ops-Core Fast MT SUPER HIGH CUT Helmet Tan	Ops-Core_Fast_MT_SUPER_HIGH_CUT_Helmet_Tan
Surefire SOCOM556-MONSTER 5.56x45 silencer	Surefire_SOCOM556-MONSTER_5.56x45_silencer
SilencerCo Osprey 9 9x19mm sound suppressor	SilencerCo_Osprey_9_9x19mm_sound_suppressor
6B43 Zabralo-Sh 6A Armor	6B43_Zabralo-Sh_6A_Armor
Silencer APB 9x18PM	Silencer_APB_9x18PM
Team Wendy EXFIL Ballistic Helmet Black	Team_Wendy_EXFIL_Ballistic_Helmet_Black
Bramit silencer for a Mosin rifle	Bramit_silencer_for_a_Mosin_rifle
MPX-SD 9x19 Integrated silencer	MPX-SD_9x19_Integrated_silencer
Leupold DeltaPoint Reflex Sight	Leupold_DeltaPoint_Reflex_Sight
Cobra EKP-8-02 reflex sight	Cobra_EKP-8-02_reflex_sight
6B5-16 Zh -86 "Uley" armored rig	6B5-16_Zh_-86_"Uley"_armored_rig
Maska 1Sch helmet (Killa)	Maska_1Sch_helmet_(Killa)
Ars Arma A18 Skanda plate carrier	Ars_Arma_A18_Skanda_plate_carrier
Vityaz 9x19 sound suppressing device	Vityaz_9x19_sound_suppressing_device
UMTBS 6sh112 Scout-Sniper	UMTBS_6sh112_Scout-Sniper
Light armored Shattered mask	Light_armored_Shattered_mask
Highcom Striker ACHHC IIIA black helmet	Highcom_Striker_ACHHC_IIIA_black_helmet
Lower half-mask	Lower_half-mask
Surefire SOCOM556-MINI MONSTER 5.56x45 Silencer	Surefire_SOCOM556-MINI_MONSTER_5.56x45_Silencer
MP5SD 9x19 silencer	MP5SD_9x19_silencer
Highcom Striker ULACH IIIA black helmet	Highcom_Striker_ULACH_IIIA_black_helmet
Belomo PK-06 reflex sight	Belomo_PK-06_reflex_sight
Nightforce ATACR 7-35x56 riflescope	Nightforce_ATACR_7-35x56_riflescope
NSPU-M night Scope	NSPU-M_night_Scope
6B3TM-01M armored rig	6B3TM-01M_armored_rig
Deadly skull mask	Deadly_skull_mask
Thunder Beast Ultra 5 Sound Suppressor	Thunder_Beast_Ultra_5_Sound_Suppressor
Wilcox Skull Lock head mount	Wilcox_Skull_Lock_head_mount
6B13 assault armor (digital flora pattern)	6B13_assault_armor_(digital_flora_pattern)
Aimpoint Micro T-1 reflex sight	Aimpoint_Micro_T-1_reflex_sight
Gemtech ONE 7.62x51 Sound Suppressor	Gemtech_ONE_7.62x51_Sound_Suppressor
Hexagon AKM 7.62x39 sound suppressor	Hexagon_AKM_7.62x39_sound_suppressor
Walther MRS reflex sight	Walther_MRS_reflex_sight
Respirator	Respirator
Zhuk-6a heavy armor	Zhuk-6a_heavy_armor
6SH118 raid backpack	6SH118_raid_backpack
Transformer Bag	Transformer_Bag
Valday 1P87 holographic sight	Valday_1P87_holographic_sight
BNTI Gzhel-K armor	BNTI_Gzhel-K_armor
BNTI LSHZ-2DTM Helmet	BNTI_LSHZ-2DTM_Helmet
Kolpak-1S riot helmet	Kolpak-1S_riot_helmet
ZSh-1-2M helmet	ZSh-1-2M_helmet
DEVTAC Ronin ballistic helmet	DEVTAC_Ronin_ballistic_helmet
IOTV Gen4 armor (high mobility kit)	IOTV_Gen4_armor_(high_mobility_kit)
Oakley Mechanism heavy duty backpack (black)	Oakley_Mechanism_heavy_duty_backpack_(black)
FLIR RS-32 2.25-9x 35mm 60Hz thermal riflescope	FLIR_RS-32_2.25-9x_35mm_60Hz_thermal_riflescope
Wartech gear rig (TV-109, TV-106)	Wartech_gear_rig_(TV-109,_TV-106)
Team Wendy EXFIL Ballistic Helmet Coyote	Team_Wendy_EXFIL_Ballistic_Helmet_Coyote
SSSh-95 Sfera-S (Sphere-S)	SSSh-95_Sfera-S_(Sphere-S)
Scav Backpack	Scav_Backpack
MSA ACH TC-2002 MICH Series Helmet	MSA_ACH_TC-2002_MICH_Series_Helmet
Altyn helmet	Altyn_helmet
Zenit-Belomo PSO 1M2-1 4x24 scope	Zenit-Belomo_PSO_1M2-1_4x24_scope
Neoprene mask	Neoprene_mask
KMZ 1P69 3-10x riflescope	KMZ_1P69_3-10x_riflescope
Sig Sauer Romeo 4 reflex sight	Sig_Sauer_Romeo_4_reflex_sight
Silencerco Hybrid 46 multi-caliber silencer	Silencerco_Hybrid_46_multi-caliber_silencer
PACA Soft Armor	PACA_Soft_Armor
Hexagon 12K sound suppressor	Hexagon_12K_sound_suppressor
Flyye MBSS Backpack	Flyye_MBSS_Backpack
Camelbak Tri-Zip Backpack	Camelbak_Tri-Zip_Backpack
Module-3M bodyarmor	Module-3M_bodyarmor
MF-UNTAR armor vest	MF-UNTAR_armor_vest
Eotech HHS-1 sight Tan	Eotech_HHS-1_sight_Tan
BlackRock chest rig	BlackRock_chest_rig
Zhuk-3 Press armor	Zhuk-3_Press_armor
Mystery Ranch Blackjack 50 backpack (multicam)	Mystery_Ranch_Blackjack_50_backpack_(multicam)
6B23-1 armor (digital flora pattern)	6B23-1_armor_(digital_flora_pattern)
Highcom Trooper TFO armor (multicam)	Highcom_Trooper_TFO_armor_(multicam)
6B13 assault armor (flora pattern)	6B13_assault_armor_(flora_pattern)
6B23-2 armor (mountain flora pattern)	6B23-2_armor_(mountain_flora_pattern)
FORT Redut-M body armor	FORT_Redut-M_body_armor
6B13 M assault armor (tan)	6B13_M_assault_armor_(tan)
IOTV Gen4 armor (assault kit)	IOTV_Gen4_armor_(assault_kit)
SSO "Attack 2" raid backpack	SSO_"Attack_2"_raid_backpack
IOTV Gen4 armor (full protection)	IOTV_Gen4_armor_(full_protection)
3V G Paratus 3-Day Operator's Tactical Backpack	3V_G_Paratus_3-Day_Operator's_Tactical_Backpack
Ana tactical Beta 2 battle backpack	Ana_tactical_Beta_2_battle_backpack
Duffle bag	Duffle_bag
Wartech Berkut VV-102 backpack	Wartech_Berkut_VV-102_backpack
6B47 Helmet with cover (flora digital)	6B47_Helmet_with_cover_(flora_digital)
Armasight NVG mask	Armasight_NVG_mask
UNTAR helmet	UNTAR_helmet
Highcom Striker ACHHC IIIA olive helmet	Highcom_Striker_ACHHC_IIIA_olive_helmet
Kiver-M Helmet	Kiver-M_Helmet
LZSh light helmet	LZSh_light_helmet
MSA ACH TC-2001 MICH Series Helmet	MSA_ACH_TC-2001_MICH_Series_Helmet
Burris FastFire 3 Reflex Sight	Burris_FastFire_3_Reflex_Sight
SHPM Firefighter's helmet	SHPM_Firefighter's_helmet
Vulkan-5 (LShZ-5) heavy helmet	Vulkan-5_(LShZ-5)_heavy_helmet
Flat screwdriver	Flat_screwdriver
Shemagh	Shemagh
4x Scope	ELCAN_SpecterDR_1x_4x_Scope
Ops-Core Fast MT SUPER HIGH CUT Helmet	Ops-Core_Fast_MT_SUPER_HIGH_CUT_Helmet
Highcom Striker ULACH IIIA helmet	Highcom_Striker_ULACH_IIIA_tan_helmet
Trijicon ACOG TA01NSN 4x32 scope	Trijicon_ACOG_TA01NSN_4x32_scope
OKP-7 reflex sight	OKP-7_reflex_sight
6B2 armor (flora)	6B2_armor_(flora)
Eotech HHS-1 sight	Eotech_HHS-1_sight
Items case	Items_case
Maska 1Sch helmet	Maska_1Sch_helmet
Immobilizing splint (alu)	Immobilizing_splint
AK-101 5.56x45 assault rifle	ak-101_5.56x45_assault_rifle
AK-102 5.56x45 assault rifle	ak-102_5.56x45_assault_rifle
AK-103 7.62x39 assault rifle	ak-103_7.62x39_assault_rifle
AK-104 7.62x39 assault rifle	ak-104_7.62x39_assault_rifle
AK-105 5.45x39 assault rifle	ak-105_5.45x39_assault_rifle
AK-74 5.45x39 assault rifle	ak-74_5.45x39_assault_rifle
AK-74M 5.45x39 assault rifle	ak-74m_5.45x39_assault_rifle
AK-74N 5.45x39 assault rifle	ak-74n_5.45x39_assault_rifle
AKM 7.62x39 assault rifle	akm_7.62x39_assault_rifle
AKMN 7.62x39 assault rifle	akmn_7.62x39_assault_rifle
AKMS 7.62x39 assault rifle	akms_7.62x39_assault_rifle
AKMSN 7.62x39 assault rifle	akmsn_7.62x39_assault_rifle
AKS-74 5.45x39 assault rifle	aks-74_5.45x39_assault_rifle
AKS-74N 5.45x39 assault rifle	aks-74n_5.45x39_assault_rifle
AS VAL	as_val
ASh-12 12.7x55 assault rifle	ash-12_12.7x55_assault_rifle
Colt M4A1 5.56x45 Assault Rifle	colt_m4a1_5.56x45_assault_rifle_not_func
DS Arms SA-58 7.62x51	ds_arms_sa-58_7.62x51_not_func
DT MDR 5.56x45 Assault Rifle	dt_mdr_5.56x45_assault_rifle_not_func
HK 416A5 5.56x45 Assault Rifle	hk_416a5_5.56x45_assault_rifle
Kalashnikov AKS-74U 5.45x39	kalashnikov_aks-74u_5.45x39
Kalashnikov AKS-74UB 5.45x39	kalashnikov_aks-74ub_5.45x39
Kalashnikov AKS-74UN 5.45x39	kalashnikov_aks-74un_5.45x39
DT MDR 7.62x51 Assault Rifle	dt_mdr_7.62x51_assault_rifle_not_func
ADAR 2-15 .223 Carbine	adar_2-15_.223_carbine_not_func
Lone Star TX-15 DML Rifle	lone_star_tx-15_dml_rifle_not_func
Simonov Semi-Automatic Carbine SKS 7.62x39	simonov_semi-automatic_carbine_sks_7.62x39
Simonov Semi-Automatic Carbine SKS 7.62x39 Hunting Rifle Version	simonov_semi-automatic_carbine_sks_7.62x39_hunting_rifle
 VPO-209 366TKM carbine	vepr_akm___vpo-209_366tkm_carbine
VPO-101 7.62x51 carbine	vepr_hunter_vpo-101_7.62x51_carbine
 VPO-136 7.62x39 carbine	vepr_km___vpo-136_7.62x39_carbine
DVL-10 Saboteur sniper rifle	dvl-10_saboteur_sniper_rifle
Mosin bolt-action infantry rifle	mosin_bolt-action_infantry_rifle
Mosin bolt-action sniper rifle	mosin_bolt-action_sniper_rifle
Orsis T-5000 .308 sniper rifle	orsis_t-5000_.308_sniper_rifle
Remington Model 700 Sniper rifle	remington_model_700_sniper_rifle
SV-98 bolt-action sniper rifle	sv-98_bolt-action_sniper_rifle
Molot VPO-215 .366 TKM rifle	molot_vpo-215_.366_tkm_rifle
RPK-16 5.45x39 light machine gun	rpk-16_5.45x39_light_machine_gun
Knight's Armament Company SR-25 7.62x51	knight's_armament_company_sr-25_7.62x51
Remington R11 RSASS 7.62x51	remington_r11_rsass_7.62x51
Special Sniper Rifle VSS Vintorez	special_sniper_rifle_vss_vintorez
Springfield Armory M1A 7.62x51	springfield_armory_m1a_7.62x51
SVDS 7.62x54 Sniper rifle	svds_7.62x54_sniper_rifle
6h5 Bayonet	6h5_bayonet
Antique axe	antique_axe
Bars A-2607- 95x18	bars_a-2607-_95x18
Bars A-2607- Damascus	bars_a-2607-_damascus
Camper axe	camper_axe
Crash Axe	crash_axe
ER Fulcrum Bayonet	er_fulcrum_bayonet
Freeman crowbar	freeman_crowbar
Kiba Arms Tactical Tomahawk	kiba_arms_tactical_tomahawk
Miller Bros. Blades M-2 Tactical Sword	m-2_tactical_sword
MPL-50 entrenching tool	mpl-50_entrenching_tool
SP-8 Survival Machete	sp-8_survival_machete
9x21 Serdyukov automatic pistol SR1MP Gyurza	9x21_serdyukov_automatic_pistol_sr1mp_gyurza
Beretta M9A3 9x19 pistol	beretta_m9a3_9x19_pistol
FN Five-seveN MK2 5.7x28 pistol	fn_five-seven_mk2_5.7x28_pistol
GLOCK 17 9x19 pistol	glock_17_9x19_pistol
GLOCK 18C 9x19 pistol	glock_18c_9x19_pistol
P226R 9x19 pistol	p226r_9x19_pistol
PB 9x18PM silenced pistol	pb_9x18pm_silenced_pistol
PM 9x18PM pistol	pm_9x18pm_pistol
PM (t) 9x18PM pistol	pm_(t)_9x18pm_pistol
Silenced Stechkin Automatic Pistol 9x18PM	silenced_stechkin_automatic_pistol_9x18pm
Stechkin Automatic Pistol 9x18PM	stechkin_automatic_pistol_9x18pm
TT pistol 7.62x25 TT Gold	tt_pistol_7.62x25_tt_gold
Yarygin MP-443 Grach 9x19 pistol	yarygin_mp-443_grach_9x19_pistol
TT pistol 7.62x25 TT	tt_pistol_7.62x25_tt
FN Five-seveN MK2 FDE Frame 5.7x28 pistol	fn_five-seven_mk2_fde_frame_5.7x28_pistol
MP-133 12ga shotgun	mp-133_12ga_shotgun
MP-153 12ga semi-automatic shotgun	mp-153_12ga_semi-automatic_shotgun
Remington Model 870 12ga shotgun	remington_model_870_12ga_shotgun
76 shotgun	saiga_12ga_ver._10_12_76_shotgun
TOZ-106 bolt-action shotgun	toz-106_bolt-action_shotgun
B&T MP9 9x19 submachinegun	b&t_mp9_9x19_submachinegun
FN P90 5.7x28 submachinegun	fn_p90_5.7x28_submachinegun
HK MP5 9x19 submachinegun (Navy 3 Round Burst)	hk_mp5_9x19_submachinegun_(navy_3_round_burst)
HK MP5 Kurz 9x19 submachinegun	hk_mp5_kurz_9x19_submachinegun
HK MP7A1 4.6x30 submachinegun	hk_mp7a1_4.6x30_submachinegun
HK MP7A2 4.6x30 submachinegun	hk_mp7a2_4.6x30_submachinegun
PP-9 Klin 9x18PMM SMG	pp-9_klin_9x18pmm_smg
PP-91 Kedr 9x18PM SMG	pp-91_kedr_9x18pm_smg
PP-91-01 Kedr-B 9x18PM SMG	pp-91-01_kedr-b_9x18pm_smg
Saiga-9 9x19 Carbine	saiga-9_9x19_carbine
SIG MPX 9x19 Submachine gun	sig_mpx_9x19_submachine_gun
Submachinegun PP-19-01 Vityaz-SN 9x19	submachinegun_19-01_vityaz-sn_9x19
B&T MP9-N 9x19 Submachinegun	b&t_mp9-n_9x19_submachinegun
F-1 Hand grenade	f-1_hand_grenade
M67 Hand grenade	m67_hand_grenade
RDG-2B Smoke grenade	rdg-2b_smoke_grenade
RGD-5 hand grenade	rgd-5_hand_grenade
Zarya stun grenade	zarya_stun_grenade
5.56x45 mm M995	5.56x45_mm_m995
9x39 mm 7N12 BP	9x39_mm_7n12_bp
4.6x30mm AP SX	4.6x30mm_ap_sx
5.45x39 mm 7N39 "Igolnik"	5.45x39_mm_7n39_igolnik
5.45x39 mm BS	5.45x39_mm_bs
7.62x39 mm BP	7.62x39_mm_bp
7.62x51 mm M61	7.62x51_mm_m61
9x39 mm 7N9 SPP	9x39_mm_7n9_spp
7.62x54R 7N37	7.62x54r_7n37
9x19 mm RIP	9x19_mm_rip
9x19 mm AP 6.3	9x19_mm_ap_6.3
5.56x45 mm M856A1	5.56x45_mm_m856a1
9x39 mm SP-6	9x39_mm_sp-6
7.62x51 mm M62	7.62x51_mm_m62
5.56x45 mm M855A1	5.56x45_mm_m855a1
7.62x54R 7N1 Sniper cartridge	7.62x54r_7n1_sniper_cartridge
5.45x39 mm BT	5.45x39_mm_bt
5.56x45 mm Warmage	5.56x45mm_warmage
7.62x54R 7BT1	7.62x54r_7bt1
5.7x28 mm SB193	5.7x28_mm_sb193
12x70 RIP	12x70_rip
12.7x55 mm PS12B	12.7x55_mm_ps12b
5.45x39 mm BP	5.45x39_mm_bp
9x19 mm Luger CCI	9x19_mm_luger_cci
5.7x28 mm SS198LF	5.7x28_mm_ss198lf
4.6x30mm Subsonic SX	4.6x30mm_subsonic_sx
4.6x30mm FMJ SX	4.6x30mm_fmj_sx
7.62x54R SNB	7.62x54r_snb
7.62x51 mm Ultra Nosler	7.62x51_mm_ultra_nosler
5.7x28 mm L191	5.7x28_mm_l191
9x21 mm SP13	9x21_mm_sp13
5.7x28 mm R37.F	5.7x28_mm_r37.f
5.56x45 mm M855	5.56x45_mm_m855
5.7x28 mm SS190	5.7x28_mm_ss190
9x21 mm SP12	9x21_mm_sp12
5.7x28 mm SS197SR	5.7x28_mm_ss197sr
7.62x51 mm M80	7.62x51_mm_m80
12.7x55 mm PS12	12.7x55_mm_ps12
5.7x28 mm R37.X	5.7x28_mm_r37.x
7.62x54R T-46M	7.62x54r_t-46m
5.56x45 mm Mk 255 Mod 0	5.56x45_mm_mk_255_mod_0
7.62x39 mm US	7.62x39_mm_us
9x18 mm PM SP7 gzh	9x18_mm_pm_sp7_gzh
5.45x39 mm PP	5.45x39_mm_pp
9x21 mm SP11	9x21_mm_sp11
9x18 mm PM PMM	9x18_mm_pm_pmm
5.56x45 mm M856	5.56x45_mm_m856
9x39 mm SP-5	9x39_mm_sp-5
9x21 mm SP10	9x21_mm_sp10
7.62x54R LPS Gzh	7.62x54r_lps_gzh
70 AP-20 Slug	12_70_ap-20_slug
4.6x30mm Action SX	4.6x30mm_action_sx
7.62x51 mm BPZ FMJ	7.62x51_mm_bpz_fmj
5.56x45 mm 55 FMJ	5.56x45_mm_55_fmj
7.62x51 mm TPZ SP	7.62x51_mm_tpz_sp
7.62x39 mm PS	7.62x39_mm_ps
5.45x39 mm SP	5.45x39_mm_sp
12.7x55 mm PS12A	12.7x55_mm_ps12a
9x18 mm PM PBM	9x18_mm_pm_pbm
5.56x45 mm 55 HP	5.56x45_mm_55_hp
7.62x39 mm HP	7.62x39_mm_hp
5.45x39 mm PS	5.45x39_mm_ps
9x18 mm PM PSV	9x18_mm_pm_psv
9x18 PM mm RG028 gzh	9x18_mm_pm_rg028_gzh
7.62x25mm TT LRNPC	7.62x25mm_tt_lrnpc
7.62x25mm TT Pst gzh	7.62x25mm_tt_pst_gzh
9x18 mm PM SP8 gzh	9x18_mm_pm_sp8_gzh
70 HP Slug Copper Sabot Premier	12_70_hp_slug_copper_sabot_premier
70 Devastator Slug	20_70_devastator_slug
7.62x25mm TT PT gzh	7.62x25mm_tt_pt_gzh
.366 TKM Geksa	.366_tkm_geksa
9x19 mm Green Tracer	9x19_mm_green_tracer
9x18 mm PM 9 BZT gzh	9x18_mm_pm_9_bzt_gzh
9x19 mm Pst gzh	9x19_mm_pst_gzh
70 HP Slug "SuperFormance"	12_70_hp_slug_superformance
7.62x25mm TT P gl	7.62x25mm_tt_p_gl
7.62x39 mm T45M	7.62x39_mm_t45m
12x70 shell with .50 BMG bullet	12x70_shell_with_.50_bmg_bullet
.366 TKM EKO	.366_tkm_eko
5.45x39 mm US	5.45x39_mm_us
7.62x25mm TT LRN	7.62x25mm_tt_lrn
9x18 mm PM PPe gzh	9x18_mm_pm_ppe_gzh
9x18 mm PM PSO gzh	9x18_mm_pm_pso_gzh
7.62x25mm TT FMJ43	7.62x25mm_tt_fmj43
5.45x39 mm FMJ	5.45x39_mm_fmj
7.62x25mm TT AKBS	7.62x25mm_tt_akbs
9x19 mm PSO gzh	9x19_mm_pso_gzh
9x18 mm PM Pst gzh	9x18_mm_pm_pst_gzh
9x18 mm PM PPT gzh	9x18_mm_pm_ppt_gzh
70 Star Slug	20_70_star_slug
5.45x39 mm HP	5.45x39_mm_hp
70 FTX Custom LIte Slug	12_70_ftx_custom_lite_slug
9x18 mm PM PRS gs	9x18_mm_pm_prs_gs
70 Flechette	12_70_flechette
70 8.5 mm "Magnum" Buckshot	12_70_8.5_mm_magnum_buckshot
5.45x39 mm T	5.45x39_mm_t
.366 TKM FMJ	.366_tkm_fmj
70 "Poleva-6u" Slug	12_70_poleva-6u_slug
9x18 mm PM PS gs PPO	9x18_mm_pm_ps_gs_ppo
70 Dual Sabot Slug	12_70_dual_sabot_slug
70 Grizzly 40 Slug	12_70_grizzly_40_slug
70 Slug Poleva-6u	20_70_slug_poleva-6u
70 Slug "Poleva-3"	20_70_slug_poleva-3
5.45x39 mm PRS	5.45x39_mm_prs
70 "Poleva-3" Slug	12_70_poleva-3_slug
12x70 6.5 mm "Express" Buckshot	12x70_6.5_mm_express_buckshot
70 7.3mm Buckshot	20_70_7.3mm_buckshot
70 5.25mm Buckshot	12_70_5.25mm_buckshot
12x70 Led slug	12x70_led_slug
70 6.2mm Buckshot	20_70_6.2mm_buckshot
12x70 7mm Buckshot	12x70_7mm_buckshot
70 5.6mm Buckshot	20_70_5.6mm_buckshot
9x18 mm PM 9 P gzh	9x18_mm_pm_9_p_gzh
20x70 7.5mm Buckshot	20x70_7.5mm_buckshot
X-47 AK 7.62x39 50 rnd magazine	x-47_ak_7.62x39_50_rnd_magazine
7.62x54r ProMag OPFOR for Archangel Mosin rifle kit, 10-round capacity	7.62x54r_promag_opfor_for_archangel_mosin_rifle_kit,_10-round_capacity
Magpul PMAG D-60 5.56x45 60-round magazine	magpul_pmag_d-60_5.56x45_60-round_magazine
30-round SR3M.130 9x39 SR3M magazine	30-round_sr3m.130_9x39_sr3m_magazine
100-round MAG5-100 5.56x45 STANAG magazine	100-round_mag5-100_5.56x45_stanag_magazine
X Products X-5 MP5 50-round 9x19 magazine	x_products_x-5_mp5_50-round_9x19_magazine
60-round MAG5-60 5.56x45 STANAG magazine	60-round_mag5-60_5.56x45_stanag_magazine
F5 MPX Drum mag 50-round 9x19 magazine	f5_mpx_drum_mag_50-round_9x19_magazine
ProMag AALVX 35 7.62x39 35-round SKS magazine.	promag_aalvx_35_7.62x39_35-round_sks_magazine.
12.7x55 magazine for ASh-12, 20-round capacity	12.7x55_magazine_for_ash-12,_20-round_capacity
60-round 6L31 5.45x39 magazine for AK-74 and compatibles	60-round_6l31_5.45x39_magazine_for_ak-74_and_compatibles
PPSH 9x18PM 84-round drum mag for PM	pm_ppsh_9x18pm_84-round_drum_mag_for_pm
Five-seveN 20-Round 5.7x28 magazine	five-seven_20-round_5.7x28_magazine
X-14 M14 50 round 7.62x51 magazine	x-14_m14_50_round_7.62x51_magazine
SA-58 7.62x51 50 rnd magazine	x-fal_fal_sa-58_7.62x51_50_rnd_magazine
76 magazine for SOK-12 and compatible weapons	maxrounds_powermag_20-round_12_76_magazine_for_sok-12_and_compatible_weapons
Standard MP7 40-round 4.6x30 magazine	standard_mp7_40-round_4.6x30_magazine
FN magazine for P90, 50-round capacity	fn_magazine_for_p90,_50-round_capacity
20-round SVD 7.62x54 magazine	20-round_svd_7.62x54_magazine
KAC Steel 10 7.62x51 10 rnd	kac_steel_10_7.62x51_10_rnd
Promag AA-70 10-round .308 M700 magazine	promag_aa-70_10-round_.308_m700_magazine
ProMag AK-A-16 73-round 7.62x39 magazine for AKM and compatibles	promag_ak-a-16_73-round_7.62x39_magazine_for_akm_and_compatibles
Standard 9x19 15-round magazine for MP9	standard_9x19_15-round_magazine_for_mp9
7.62x51 metal magazine for VPO-101 and compatibles, 10-round capacity	7.62x51_metal_magazine_for_vpo-101_and_compatibles,_10-round_capacity
10-round .308 DVL-10 magazine	10-round_.308_dvl-10_magazine
95-round 5.45x39 magazine for RPK-16 and compatibles	95-round_5.45x39_magazine_for_rpk-16_and_compatibles
Standard 9x19 20-round magazine for MP9	standard_9x19_20-round_magazine_for_mp9
Standard MP7 20-round 4.6x30 magazine	standard_mp7_20-round_4.6x30_magazine
4-shell M870 12ga magazine cap	4-shell_m870_12ga_magazine_cap
Standard MP5 20-round 9x19 magazine	standard_mp5_20-round_9x19_magazine
Promag AA-70 20-round .308 M700 magazine	promag_aa-70_20-round_.308_m700_magazine
M14 30 round 7.62x51 magazine	m14_30_round_7.62x51_magazine
10-round polymer magazine 7.62x54R for SV-98	10-round_polymer_magazine_7.62x54r_for_sv-98
P226 Extended magazine 9x19	p226_extended_magazine_9x19
Molot magazine for AK and compatibles, 75-round capacity	molot_magazine_for_ak_and_compatibles,_75-round_capacity
10-round SVD 7.62x54 magazine	10-round_svd_7.62x54_magazine
HK Polymer mag 30 5.56x45 STANAG 30-round magazine	hk_polymer_mag_30_5.56x45_stanag_30-round_magazine
SGMT Drum mag for Glock 9x19, 50 rounds capacity	sgmt_drum_mag_for_glock_9x19,_50_rounds_capacity
12.7x55 magazine for ASh-12, 10-round capacity	12.7x55_magazine_for_ash-12,_10-round_capacity
LR GEN M3 20 7.62x51 20 rnd	pmag_sr_lr_gen_m3_20_7.62x51_20_rnd
12-round .308 MDT AICS M700 magazine	12-round_.308_mdt_aics_m700_magazine
Arsenal CWP 30-round 5.56x45 magazine for SLR-106 and compatible weapons	arsenal_cwp_30-round_5.56x45_magazine_for_slr-106_and_compatible_weapons
20-round 6L25 9x39 VSS magazine	20-round_6l25_9x39_vss_magazine
Standard 9x19 30-round magazine for MP9	standard_9x19_30-round_magazine_for_mp9
Standard MP7 30-round 4.6x30 magazine	standard_mp7_30-round_4.6x30_magazine
Glock 9x19 magazine	glock_9x19_magazine
PMAG GEN M3 20 5.56x45 STANAG 20-round magazine	pmag_gen_m3_20_5.56x45_stanag_20-round_magazine
5-round .308 AICS M700 magazine	5-round_.308_aics_m700_magazine
Magpul PMAG .308 AC 5-round M700 magazine	magpul_pmag_.308_ac_5-round_m700_magazine
Standard MPX 20-round 9x19 magazine	standard_mpx_20-round_9x19_magazine
ProMag SKS-A5 7.62x39 20-round SKS magazine	promag_sks-a5_7.62x39_20-round_sks_magazine
5-round .308 M700 magazine	5-round_.308_m700_magazine
MPX with TTI Base pad +11 41-round 9x19 magazine	mpx_with_tti_base_pad_ 11_41-round_9x19_magazine
Magpul PMAG .308 AC 10-round M700 magazine	magpul_pmag_.308_ac_10-round_m700_magazine
10-round .308 AICS M700 magazine	10-round_.308_aics_m700_magazine
SA-58 7.62x51 30 rnd	fal_sa-58_7.62x51_30_rnd
TROY Battlemag 5.56x45 STANAG 30-round magazine	troy_battlemag_5.56x45_stanag_30-round_magazine
MP-153 8-rd magazine extension	mp-153_8-rd_magazine_extension
L1A1 7.62x51 30 rnd magazine	british_fal_l1a1_7.62x51_30_rnd_magazine
P226 magazine	p226_magazine
10-round 6L24 9x39 VSS magazine	10-round_6l24_9x39_vss_magazine
5-round .308 T-5000 magazine	5-round_.308_t-5000_magazine
PMAG GEN M3 30 5.56x45 STANAG 30-round magazine	pmag_gen_m3_30_5.56x45_stanag_30-round_magazine
Standard MP5 30-round 9x19 magazine	standard_mp5_30-round_9x19_magazine
Pmag GL9 polymer magazine	pmag_gl9_polymer_magazine
Standard 9x19 25-round magazine for MP9	standard_9x19_25-round_magazine_for_mp9
M9A3 9x19 17-round magazine	m9a3_9x19_17-round_magazine
PUFGUN SG-919 30 30-round 9x19 magazine for PP-19-01	pufgun_sg-919_30_30-round_9x19_magazine_for_pp-19-01
KAC Steel 20 7.62x51 20 rnd	kac_steel_20_7.62x51_20_rnd
Regular 4rnd magazine for Mosin rifle	regular_4rnd_magazine_for_mosin_rifle
Palm US AK30 7.62x39 magazine for AK and compatibles, 30-round capacity	palm_us_ak30_7.62x39_magazine_for_ak_and_compatibles,_30-round_capacity
"Big Stick" 9x19 magazine for Glock 9x19	big_stick_9x19_magazine_for_glock_9x19
40-round PMAG GEN M3 40 5.56x45 STANAG magazine	40-round_pmag_gen_m3_40_5.56x45_stanag_magazine
HK Steel Maritime 5.56x45 STANAG 30-round magazine	hk_steel_maritime_5.56x45_stanag_30-round_magazine
Izhmash AK magazine (issued ‘55 or later) 30-round for 7.62x39 AK and compatibles	izhmash_ak_magazine_(issued_‘55_or_later)_30-round_for_7.62x39_ak_and_compatibles
PMAG GEN M3 W 30 5.56x45 STANAG 30-round magazine	pmag_gen_m3_w_30_5.56x45_stanag_30-round_magazine
Standard 9x18PM 30-round magazine for PP-91	standard_9x18pm_30-round_magazine_for_pp-91
10 rnds. SKS internal box magazine 7.62x39	10_rnds._sks_internal_box_magazine_7.62x39
10-round .308 M700 magazine	10-round_.308_m700_magazine
PMAG GEN M3 10 5.56x45 STANAG 10-round magazine	pmag_gen_m3_10_5.56x45_stanag_10-round_magazine
AKM GEN M3 7.62x39 magazine for AK and compatibles, 30-round capacity	pmag_30_ak_akm_gen_m3_7.62x39_magazine_for_ak_and_compatibles,_30-round_capacity
M1A 20 round 7.62x51 magazine	m1a_20_round_7.62x51_magazine
SA-58 "MMW" 7.62x51 20 rnd plastic mag	fal_sa-58_mmw_7.62x51_20_rnd_plastic_mag
MP-443 9x19 18-round magazine	mp-443_9x19_18-round_magazine
HK PM Gen.2 5.56x45 STANAG 30-round magazine	hk_pm_gen.2_5.56x45_stanag_30-round_magazine
SR1-MP magazine	sr1-mp_magazine
5-shot MC 20-01 Sb.3 20ga magazine for TOZ-106	5-shot_mc_20-01_sb.3_20ga_magazine_for_toz-106
7.62x51 metal magazine for VPO-101 and compatibles, 5-round capacity	7.62x51_metal_magazine_for_vpo-101_and_compatibles,_5-round_capacity
SA-58 7.62x51 10 rnd	fal_sa-58_7.62x51_10_rnd
Pmag 30 AK74 GEN M3 5.45x39 magazine for AK and compatibles, 30-round capacity	pmag_30_ak74_gen_m3_5.45x39_magazine_for_ak_and_compatibles,_30-round_capacity
30-round 5.45x39 magazine for AK-12 and compatibles	30-round_5.45x39_magazine_for_ak-12_and_compatibles
Standard MPX 30-round 9x19 magazine	standard_mpx_30-round_9x19_magazine
Standard PP-19-01 30-round 9x19 magazine	standard_pp-19-01_30-round_9x19_magazine
7-shell M870x7 12ga magazine	7-shell_m870x7_12ga_magazine
45-round 6L26 5.45x39 magazine for AK-74 and compatibles	45-round_6l26_5.45x39_magazine_for_ak-74_and_compatibles
SAI-02 10-round 12x76 magazine for SOK-12 and compatible weapons	sai-02_10-round_12x76_magazine_for_sok-12_and_compatible_weapons
Bakelite 7.62x39 magazine for AK and compatibles, 40-round capacity	bakelite_7.62x39_magazine_for_ak_and_compatibles,_40-round_capacity
Standard 9x18PM 20-round magazine for PP-91	standard_9x18pm_20-round_magazine_for_pp-91
30-round 7.62x39 magazine for АK-103 and compatible weapons	30-round_7.62x39_magazine_for_ak-103_and_compatible_weapons
4-shot MC 20-01 Sb.3 20ga magazine for TOZ-106	4-shot_mc_20-01_sb.3_20ga_magazine_for_toz-106
6L18 45-round 5.45x39 magazine for AK-74 and compatible weapons	6l18_45-round_5.45x39_magazine_for_ak-74_and_compatible_weapons
10-shell M870x10 12ga magazine	10-shell_m870x10_12ga_magazine
Izhmash 6L10 7.62x39 magazine for AK and compatibles, 30-round capacity	izhmash_6l10_7.62x39_magazine_for_ak_and_compatibles,_30-round_capacity
TT-105 7.62x25 TT Magazine	tt-105_7.62x25_tt_magazine
6L29 30-round 5.56x45 magazine for АK-101 and compatible weapons	6l29_30-round_5.56x45_magazine_for_ak-101_and_compatible_weapons
90-93 9x18PM Magazine, for 8 PM rounds	90-93_9x18pm_magazine,_for_8_pm_rounds
PUFGUN SG-919 20 20-round 9x19 magazine for PP-19-01	pufgun_sg-919_20_20-round_9x19_magazine_for__pp-19-01
Standard APS 9x18PM 20-round magazine	standard_aps_9x18pm_20-round_magazine
SA-58 7.62x51 20 rnd	fal_sa-58_7.62x51_20_rnd
6L20 30-round 5.45x39 magazine for AK-74 and compatible weapons	6l20_30-round_5.45x39_magazine_for_ak-74_and_compatible_weapons
MP-153 5-rd magazine extension	mp-153_5-rd_magazine_extension
10-round Saiga 545 5.45x39 magazine for AK-74 and compatibles	10-round_saiga_545_5.45x39_magazine_for_ak-74_and_compatibles
Molot 6P2.Sb-11 7.62x39 magazine for AK and compatibles, 40-round capacity	molot_6p2.sb-11_7.62x39_magazine_for_ak_and_compatibles,_40-round_capacity
76 magazine for SOK-12 and compatible weapons	sb.5_5-round_12_76_magazine_for_sok-12_and_compatible_weapons
8-shell MP-133x8 12ga magazine	8-shell_mp-133x8_12ga_magazine
6-shell MP-133x6 12ga magazine	6-shell_mp-133x6_12ga_magazine
Colt AR-15 5.56x45 STANAG 30-round magazine	colt_ar-15_5.56x45_stanag_30-round_magazine
30-round 6L23 5.45x39 magazine for AK-74 and compatibles	30-round_6l23_5.45x39_magazine_for_ak-74_and_compatibles
7.62x39 ribbed metal magazine for AK and compatibles, 10-round capacity	7.62x39_ribbed_metal_magazine_for_ak_and_compatibles,_10-round_capacity
MP-153 6-rd magazine extension	mp-153_6-rd_magazine_extension
MP-153 7-rd magazine extension	mp-153_7-rd_magazine_extension
Izhmash 7.62x39 AKMS aluminium magazine for AK and compatibles, 30-round capacity	izhmash_7.62x39_akms_aluminium_magazine_for_ak_and_compatibles,_30-round_capacity
10-round Izh.9x19 Sb.7 magazine	10-round_izh.9x19_sb.7_magazine
2-shot MC 20-01 Sb.3 20ga magazine for TOZ-106	2-shot_mc_20-01_sb.3_20ga_magazine_for_toz-106
Izhmash 7.62x39 AK aluminium magazine for AK and compatibles, 10-round capacity	izhmash_7.62x39_ak_aluminium_magazine_for_ak_and_compatibles,_10-round_capacity
LA-5 tactical device	la-5_tactical_device
Zenit Perst-3 tactical device	zenit_perst-3_tactical_device
PEQ-15 tactical device	an_peq-15_tactical_device
Steiner Dbal PL tactical flashlight	steiner_dbal_pl_tactical_flashlight
TAC 2 tactical flashlight	las_tac_2_tactical_flashlight
2U "Kleh" tactical flashlight	2u_kleh_tactical_flashlight
2IRS Klesch flashlight + laser designator	2irs_klesch_flashlight_ _laser_designator
Surefire XC1 tactical flashlight	surefire_xc1_tactical_flashlight
Glock Tactical GL21 flashlight with laser	glock_tactical_gl21_flashlight_with_laser
PEQ-2 tactical device	an_peq-2_tactical_device
Holosun LS321 Tactical device	holosun_ls321_tactical_device
DLP "Tactical Precision" LAM Module for TT Pistol	dlp_tactical_precision_lam_module_for_tt_pistol
2P Klesch flashlight + laser designator	2p_klesch_flashlight_ _laser_designator
X400 tactical flashlight	x400_tactical_flashlight
NcSTAR Tactical blue laser LAM-Module	ncstar_tactical_blue_laser_lam-module
Armytek Predator Pro v3 XHP35 HI Flashlight	armytek_predator_pro_v3_xhp35_hi_flashlight
Ultrafire WF-501B Flashlight	ultrafire_wf-501b_flashlight
AI-2 medikit	ai-2_medikit
Analgin painkillers	analgin_painkillers
Aseptic bandage	aseptic_bandage
Immobilizing splint	immobilizing_splint
Army bandage	army_bandage
Zenit RK-1 Foregrip on B-25U mount	zenit_rk-1_foregrip_on_b-25u_mount
Zenit RK-2 Foregrip	zenit_rk-2_foregrip
SE-5 Express Grip	se-5_express_grip
B&T MP9-N Vertical grip	b&t_mp9-n_vertical_grip
Zenit RK-1 Foregrip	zenit_rk-1_foregrip
Fortis Shift tactical grip	fortis_shift_tactical_grip
Hera Arms CQR tactical grip	hera_arms_cqr_tactical_grip
SI "Cobra tactical" tactical grip	si_cobra_tactical_tactical_grip
Magpul M-LOK AFG Tactical grip	magpul_m-lok_afg_tactical_grip
Zenit RK-5 Foregrip	zenit_rk-5_foregrip
Zenit RK-6 Foregrip	zenit_rk-6_foregrip
Magpul AFG grip FDE	magpul_afg_grip_fde
Magpul AFG grip FG	magpul_afg_grip_fg
Magpul AFG grip OD	magpul_afg_grip_od
Magpul AFG grip black	magpul_afg_grip_black
Zenit RK-0 Foregrip	zenit_rk-0_foregrip
Magpul RVG grip black	magpul_rvg_grip_black
Zenit RK-4 Foregrip	zenit_rk-4_foregrip
BCM MOD.3 Tactical grip	bcm_mod.3_tactical_grip
RTM Pillau Tactical grip	rtm_pillau_tactical_grip
KAC Vertical pistol grip	kac_vertical_pistol_grip
Tango Down Stubby BGV-MK46K tactical grip Black	tango_down_stubby_bgv-mk46k_tactical_grip_black
Tango Down Stubby BGV-MK46K tactical grip FDE	tango_down_stubby_bgv-mk46k_tactical_grip_fde
Tango Down Stubby BGV-MK46K tactical grip FG	tango_down_stubby_bgv-mk46k_tactical_grip_fg
Viking Tactical UVG Tactical grip	viking_tactical_uvg_tactical_grip
ASh-12 Vertical pistol grip	ash-12_vertical_pistol_grip
T-5000 Pad	t-5000_pad
Magpul M-LOK AFG Tactical grip	magpul_m-lok_afg_(flat_dark_earth)_tactical_grip
Magpul M-LOK AFG Tactical grip	magpul_m-lok_afg_(olive_drab)_tactical_grip
Magpul M-LOK AFG Tactical grip	magpul_m-lok_afg_(stealth_gray)_tactical_grip
Hera Arms CQR pistol grip-stock	hera_arms_cqr_pistol_grip-stock
HK Ergo PSG-1 style pistol grip for AR-15 based systems	hk_ergo_psg-1_style_pistol_grip_for_ar-15_based_systems
Orsis T-5000 Pistol Grip	orsis_t-5000_pistol_grip
Fancy TT side grips	fancy_tt_side_grips
TSNIITOCHMASH bakelite PB side grips	tsniitochmash_bakelite_pb_side_grips
Naroh Arms GRAL-S Pistol grip for AR-15-compatible weapons	naroh_arms_gral-s_pistol_grip_for_ar-15-compatible_weapons
KGB MG-47 pistol grip for AK	kgb_mg-47_pistol_grip_for_ak
Magpul MOE pistol grip for AK	magpul_moe_pistol_grip_for_ak
US Palm pistol grip for AK	us_palm_pistol_grip_for_ak
Hogue Chain link pistol grip for P226	hogue_chain_link_pistol_grip_for_p226
Magpul MOE AR-15 pistol grip	magpul_moe_ar-15_pistol_grip
Magpul MOE AR-15 pistol grip (FDE)	magpul_moe_ar-15_pistol_grip_(fde)
HK Grip V.2 pistol grip for AR-15 based systems	hk_grip_v.2_pistol_grip_for_ar-15_based_systems
HK Battle Grip with Beavertail pistol grip for AR-15 based systems	hk_battle_grip_with_beavertail_pistol_grip_for_ar-15_based_systems
Zenit RK-3 AK pistol grip	zenit_rk-3_ak_pistol_grip
Fab Defence AG-58 pistol grip for VZ-58	fab_defence_ag-58_pistol_grip_for_vz-58
PM-Laser TT-206 side grips with LAM	pm-laser_tt-206_side_grips_with_lam
Tacfire pistol grip for Mosin rifle	tacfire_pistol_grip_for_mosin_rifle
Skeletonized AR-15 pistol grip	skeletonized_ar-15_pistol_grip
Razor Arms TT rubber grips	razor_arms_tt_rubber_grips
Stark AR Rifle Grip (FDE) for AR-15-compatible weapons	stark_ar_rifle_grip_(fde)_for_ar-15-compatible_weapons
Stark AR Rifle Grip (black) for AR-15-compatible weapons	stark_ar_rifle_grip_(black)_for_ar-15-compatible_weapons
Hera Arms HG-15 pistol grip for AR-15 based systems	hera_arms_hg-15_pistol_grip_for_ar-15_based_systems
TAPCO SAW-Style FDE pistol grip for AK	tapco_saw-style_fde_pistol_grip_for_ak
TAPCO SAW-Style black pistol grip for AK	tapco_saw-style_black_pistol_grip_for_ak
Fab AG FAL pistol grip for SA-58	fab_ag_fal_pistol_grip_for_sa-58
TAPCO SAW-Style black pistol grip for SA-58	tapco_saw-style_black_pistol_grip_for_sa-58
AS VAL Pistol grip-buffer tube	as_val_pistol_grip-buffer_tube
Hogue OverMolded Rubber Grip Black	hogue_overmolded_rubber_grip_black
Hogue OverMolded Rubber Grip FDE	hogue_overmolded_rubber_grip_fde
Hogue OverMolded Rubber Grip Ghillie Earth	hogue_overmolded_rubber_grip_ghillie_earth
Hogue OverMolded Rubber Grip Ghillie Green	hogue_overmolded_rubber_grip_ghillie_green
Hogue OverMolded Rubber Grip OD Green	hogue_overmolded_rubber_grip_od_green
Rubber with finger grooves pistol grip for P226	rubber_with_finger_grooves_pistol_grip_for_p226
Izhmash SVDS pistol grip	izhmash_svds_pistol_grip
SI Enhanced pistol grip for AK	si_enhanced_pistol_grip_for_ak
SI Enhanced pistol grip for AK FDE	si_enhanced_pistol_grip_for_ak_fde
ZMZ Polymer pistol grip for PP-91	zmz_polymer_pistol_grip_for_pp-91
HK "Battle Grip" pistol grip for AR-15 based systems	hk_battle_grip_pistol_grip_for_ar-15_based_systems
Colt A2 AR-15 pistol grip	colt_a2_ar-15_pistol_grip
Desert Tech pistol grip for MDR	desert_tech_pistol_grip_for_mdr_fde
Desert Tech pistol grip for MDR Black	desert_tech_pistol_grip_for_mdr_black
Axelson Tacical MK.25 pistol grip for P226	axelson_tacical_mk.25_pistol_grip_for_p226
MIAD Pistol grip for AR-15 based systems	miad_pistol_grip_for_ar-15_based_systems
M14ALCS(MOD. 0) pistol grip for M14	m14alcs(mod._0)_pistol_grip_for_m14
Fab Defence AGR-870 pistol grip for Remington-870	fab_defence_agr-870_pistol_grip_for_remington-870
TAPCO SAW-Style pistol grip for SKS INTRAFUSE Kit	tapco_saw-style_pistol_grip_for_sks_intrafuse_kit
Magpul Pistol Grip for Pro 700 Kit	magpul_pistol_grip_for_pro_700_kit
Izhmash AK-12 regular pistol grip	izhmash_ak-12_regular_pistol_grip
Pachmayr tactical rubber grip	pachmayr_tactical_rubber_grip
DI ECS FDE pistol grip for AR-15 based systems	di_ecs_fde_pistol_grip_for_ar-15_based_systems
Wooden Sig Sauer Elite pistol grip for P226	wooden_sig_sauer_elite_pistol_grip_for_p226
Wooden Izhmash AKM pistol grip for AK	wooden_izhmash_akm_pistol_grip_for_ak
AS VAL Pistol grip	as_val_pistol_grip
Standard TT side grips	standard_tt_side_grips
Black polymer Sig Sauer pistol grip for P226	black_polymer_sig_sauer_pistol_grip_for_p226
Emperor scorpion Sig Sauer pistol grip for P226	emperor_scorpion_sig_sauer_pistol_grip_for_p226
Pistol grip SIG MPX	pistol_grip_sig_mpx
APS bakelite side-pieces	aps_bakelite_side-pieces
Hogue like TT rubber grips	hogue_like_tt_rubber_grips
Regular "DS Arms" pistol grip for SA-58	regular_ds_arms_pistol_grip_for_sa-58
PP-19-01 Izhmash pistol grip	pp-19-01_izhmash_pistol_grip
Izhmash AKM bakelite pistol grip	izhmash_akm_bakelite_pistol_grip
Izhmash AK bakelite pistol grip (6P4 Sb.8V)	izhmash_ak_bakelite_pistol_grip_(6p4_sb.8v)
Polymer Izhmekh pistol grip for MP-443	polymer_izhmekh_pistol_grip_for_mp-443
Izhmash AK polymer pistol grip (6P1 Sb.8)	izhmash_ak_polymer_pistol_grip_(6p1_sb.8)
TOZ 002 pistol grip for TOZ-106	toz_002_pistol_grip_for_toz-106
Molot AK bakelite pistol grip	molot_ak_bakelite_pistol_grip
Izhmash AK-74 Textolite pistol grip (6P4 Sb.9)	izhmash_ak-74_textolite_pistol_grip_(6p4_sb.9)
Polymer pistol grip for M9A3	polymer_pistol_grip_for_m9a3
SI M Frame safety glasses	si_m_frame_safety_glasses
Round frame sunglasses	round_frame_sunglasses
Crossbow tactical glasses	crossbow_tactical_glasses
Anti-fragmentation glasses	anti-fragmentation_glasses
Pyramex Proximity safety glasses	pyramex_proximity_safety_glasses
RayBench Aviator glasses	raybench_aviator_glasses
Gascan glasses	gascan_glasses
6B34 Anti-fragmentation glasses	6b34_anti-fragmentation_glasses
RayBench Hipster Reserve sunglasses	raybench_hipster_reserve_sunglasses
Dundukk sport sunglasses	dundukk_sport_sunglasses
Tactical glasses	tactical_glasses
Norotos Titanium Advanced Tactical Mount	norotos_titanium_advanced_tactical_mount
Dual Dovetail Mount for PVS-14 monocular	dual_dovetail_mount_for_pvs-14_monocular
Wilcox Interface for PVS-7	wilcox_interface_for_pvs-7
PNV-10T dovetail adapter	pnv-10t_dovetail_adapter
SLAAP armor Plate (Tan)	slaap_armor_plate_(tan)
LSHZ-2DTM Aventail	lshz-2dtm_aventail
TW EXFIL Ear Covers	tw_exfil_ear_covers_black
Ops-Core Fast Side Armor	ops-core_fast__side_armor
Crye Airframe Chops	crye_airframe_chops
Crye Airframe Ears	crye_airframe_ears
Ops-Core Fast GUNSIGHT Mandible	ops-core_fast_gunsight_mandible
TW EXFIL Ear Covers Coyote	tw_exfil_ear_covers_coyote
LSHZ-2DTM Cover	lshz-2dtm_cover
HK MP5 Kurz Upper receiver	hk_mp5_kurz_upper_receiver
Noveske Gen.3 5.56x45 Upper receiver for AR systems	noveske_gen.3_5.56x45_upper_receiver_for_ar_systems
Vltor MUR-1S 5.56x45 Upper receiver for AR systems	vltor_mur-1s_5.56x45_upper_receiver_for_ar_systems
Glock Zev Tech Hex Spartan slide	glock_zev_tech_hex_spartan_slide
TWS Dog leg rail dust cover for AK	tws_dog_leg_rail_dust_cover_for_ak
M9A3 9x19 pistol slide	m9a3_9x19_pistol_slide
Polymer80 PS9 Glock slide	polymer80_ps9_glock_slide
Zev Tech Hex Gen3 slide	zev_tech_hex_gen3_slide
Fab Defence PDC dust cover for АК-74	fab_defence_pdc_dust_cover_for_ак-74
Upper receiver B&T 9x19 for MP9-N SMG	upper_receiver_b&t_9x19_for_mp9-n_smg
P226 Axelson tactical Mk.25 pistol slide	p226_axelson_tactical_mk.25_pistol_slide
Upper receiver HK 416A5 5.56x45 for 416A5	upper_receiver_hk_416a5_5.56x45_for_416a5
Molot VPO-101 dust cover	molot_vpo-101_dust_cover
Lightweight upper 5.56x45 for TX15 rifle	lightweight_upper_5.56x45_for_tx15_rifle
Zenit B-33 dust cover for AK-74	zenit_b-33_dust_cover_for_ak-74
DS Arms Extreme Duty dust cover for SA58	ds_arms_extreme_duty_dust_cover_for_sa58
Izhmash regual dust cover for RPK-16	izhmash_regual_dust_cover_for_rpk-16
HK MP5SD Upper receiver	hk_mp5sd_upper_receiver
Izhmash AKS-74UB Dust cover	izhmash_aks-74ub_dust_cover
Glock 9x19 Viper Cut slide	glock_9x19_viper_cut_slide
FN Upper receiver for P90	fn_upper_receiver_for_p90
Glock 9x19 Moto Cut slide	glock_9x19_moto_cut_slide
Glock Alpha Wolf Custom slide	glock_alpha_wolf_custom_slide
Glock Alpha Wolf slide	glock_alpha_wolf_slide
P226 Sig Emperor scorpion pistol slide	p226_sig_emperor_scorpion_pistol_slide
AKademia Bastion dust cover for АК	akademia_bastion_dust_cover_for_ак
Upper receiver of the first generation SIG MPX	upper_receiver_of_the_first_generation_sig_mpx
Izhmash SVDS dust cover	izhmash_svds_dust_cover
Upper receiver ADAR 2-15 5.56x45 for 2-15 assault rifle	upper_receiver_adar_2-15_5.56x45_for_2-15_assault_rifle
FN EFFEN 90 Upper receiver for P90	fn_effen_90_upper_receiver_for_p90
Upper receiver Colt M4A1 5.56x45 for M4A1 assault rifle	upper_receiver_colt_m4a1_5.56x45_for_m4a1_assault_rifle
P226 Sig Stainless elite pistol slide	p226_sig_stainless_elite_pistol_slide
P226 Sig Legion full size pistol slide	p226_sig_legion_full_size_pistol_slide
HK MP5 Upper receiver	hk_mp5_upper_receiver
Custom SVDS dust cover	custom_svds_dust_cover
Upper receiver KAC 7.62x51 for SR-25 rifle	upper_receiver_kac_7.62x51_for_sr-25_rifle
SIG Sauer P226R 9x19 pistol slide	sig_sauer_p226r_9x19_pistol_slide
Glock 9x19 slide	glock_9x19_slide
Izhmash Vityaz-SN receiver cover	izhmash_vityaz-sn_receiver_cover
FN Upper receiver for PS90	fn_upper_receiver_for_ps90
VSS Vintorez dust cover	vss_vintorez_dust_cover
AS VAL Dust cover	as_val_dust_cover
Regular dust cover for FAL	regular_dust_cover_for_fal
Izhmash АK-74M dust cover (6P34 0-1)	izhmash_аk-74m_dust_cover_(6p34_0-1)
Molot AKM type dust cover	molot_akm_type_dust_cover
Izhmash AK-74 dust cover (6P1 0-1)	izhmash_ak-74_dust_cover_(6p1_0-1)
AKS-74U Dust cover (6P26 Sb.7)	aks-74u_dust_cover_(6p26_sb.7)
Izhmash AKM dust cover (6P1 0-1)	izhmash_akm_dust_cover_(6p1_0-1)
Izhmash SOK-12 Sb.0-2 dust cover	izhmash_sok-12_sb.0-2_dust_cover
Izhmash Vityaz receiver cover	izhmash_vityaz_receiver_cover
Glock 18C 9x19 slide	glock_18c_9x19_slide
Five-seveN MK2 pistol slide	five-seven_mk2_pistol_slide
SIG double latch charging handle for MPX	sig_double_latch_charging_handle_for_mpx
B&T charging handle for MP9	b&t_charging_handle_for_mp9
Raptor charging handle for AR-15	raptor_charging_handle_for_ar-15
FN charge handle for P90	fn_charge_handle_for_p90
KAC Charging Handle for SR-25	kac_charging_handle_for_sr-25
Colt AR-15 charging handle for AR-15	colt_ar-15_charging_handle_for_ar-15
MP5 Cocking Handle	mp5_cocking_handle
Badger Ordnance Tactical Charging Handle Latch	badger_ordnance_tactical_charging_handle_latch
KAC Ambidextrous Charging Handle for AR-10	kac_ambidextrous_charging_handle_for_ar-10
HK Extended latch Charging Handle	hk_extended_latch_charging_handle
ADAR 2-15 charging handle for AR-15	adar_2-15_charging_handle_for_ar-15
Geissele "SCH" charging handle for MPX	geissele_sch_charging_handle_for_mpx
K&M The Handler charge handle for P90	k&m_the_handler_charge_handle_for_p90
Zenit RP-1 charge handle for AK	zenit_rp-1_charge_handle_for_ak
SIG single latch charging handle for MPX	sig_single_latch_charging_handle_for_mpx
MP5 Kurz Cocking Handle	mp5_kurz_cocking_handle
SVDS Gas tube	svds_gas_tube
Molot AKM type gas tube	molot_akm_type_gas_tube
JP Enterprises Gas System-5b	jp_enterprises_gas_system-5b
Handguard with a gas block combo by TROY Industries for AK	handguard_with_a_gas_block_combo_by_troy_industries_for_ak
VS-24 Handguard with a VS-33c gas block combo for AK	vs-24_handguard_with_a_vs-33c_gas_block_combo_for_ak
JP Enterprises Gas System-6	jp_enterprises_gas_system-6
KAC Low Profile Gas Block	kac_low_profile_gas_block
Kiba Arms VDM CS gas tube	kiba_arms_vdm_cs_gas_tube
Windham Weaponry Rail Gas Block	windham_weaponry_rail_gas_block
MK12 Low Profile Gas Block	mk12_low_profile_gas_block
PP-19-01 gas tube	pp-19-01_gas_tube
AKS-74U Gas tube	aks-74u_gas_tube
HK 416A5 Regular Low Profile Gas Block	hk_416a5_regular_low_profile_gas_block
AKM (6P1 Sb.1-2) gas tube	akm_(6p1_sb.1-2)_gas_tube
AK-74 Gas tube	ak-74_gas_tube
Colt M4 Front sight	colt_m4_front_sight
VPO-101 Gas tube	vpo-101_gas_tube
UltiMAK M1-B gas tube for AK	ultimak_m1-b_gas_tube_for_ak
KAC QDC Flash supressor kit 7.62x51 flash hider	kac_qdc_flash_supressor_kit_7.62x51_flash_hider
SAI Jail Break 5.56x45 for AR-15	sai_jail_break_5.56x45_for_ar-15
Muzzlebrake Precision Armament M-11 7.62x51 for AR-10	muzzlebrake_precision_armament_m-11_7.62x51_for_ar-10
Fortis Red Brake 7.62x51 muzzle brake for AR-10	fortis_red_brake_7.62x51_muzzle_brake_for_ar-10
Desert Tech .308 Flash hider	desert_tech_.308_flashhider
Muzzle brake Keeno Arms SHREWD 7.62x51 for AR-10	muzzlebrake_keeno_arms_shrewd_7.62x51_for_ar-10
Lantac Drakon 7.62x39 muzzle brake & compensator for AK	lantac_drakon_7.62x39_muzzlebrake_&_compensator_for_ak
JP Enterprises tactical compensator 7.62x51 muzzlebrake & compensator for M14	jp_enterprises_tactical_compensator_7.62x51_muzzlebrake_&_compensator_for_m14
Witt Machine muzzle brake for Mosin rifle	witt_machine_muzzlebrake_for_mosin_rifle
Lantac Dragon 7.62x51 muzzle brake	lantac_dragon_7.62x51_muzzlebrake
Bulletec ST-6012 5.56x45 Flash hider for AR-15	bulletec_st-6012_5.56x45_flashhider_for_ar-15
compensator	izhmash_9x19_pp-19-01_muzzle_brake_compensator
Daniel Defense Wave Muzzle Brake 7.62x51	daniel_defence_wave_muzzle_brake_7.62x51
Lantac "Blast mitigation device" 7.62x51	lantac_blast_mitigation_device_7.62x51
Venom Antidote muzzle brake & compensator for AK	venom_antidote_muzzlebrake_&_compensator_for_ak
Muzzlebrake Odin Works Atlas-7 7.62x51 for AR-10	muzzlebrake_odin_works_atlas-7_7.62x51_for_ar-10
Nordic Corvette 5.56x45 compensator for AR-15	nordic_corvette_5.56x45_compensator_for_ar-15
Strike Industries G4 slide compensator 9x19	strike_industries_g4_slide_compensator_9x19
Muzzle brake Vendetta precision VP-09 5.56x45	muzzle_brake_vendetta_precision_vp-09_5.56x45
PWS CQB 74 5.45x39 Muzzle brake	pws_cqb_74_5.45x39_muzzle_brake
PWS CQB 5.56 x 45 Muzzle brake	pws_cqb_5.56_x_45_muzzle_brake
Carver Custom 4 Port 9x19 muzzle brake	carver_custom_4_port_9x19_muzzle_brake
Thunder Beast 30CB Muzzle Brake 7.62x51	thunder_beast_30cb_muzzle_brake_7.62x51
Nordic Corvette 7.62x51 muzzle brake for AR-10	nordic_corvette_7.62x51_muzzle_brake_for_ar-10
HK Noveske style muzzle brake & compensator for MP-5	hk_noveske_style_muzzlebrake_&_compensator_for_mp-5
Double Diamond flash hider	double_diamond_flash_hider
Tromix Monster Claw 12ga muzzle brake	tromix_monster_claw_12ga_muzzle_brake
Good Iron 7.62x51 muzzle brake & compensator for M14	good_iron_7.62x51_muzzlebrake_&_compensator_for_m14
SRVV "Mk.2.0" compensator 7.62x54 for SV-98	srvv_mk.2.0_compensator_7.62x54_for_sv-98
Annihilator 7.62x39, 5.56x45 and 9mm flash hider for AR-15	annihilator_7.62x39,_5.56x45_and_9mm_flash_hider_for_ar-15
Texas Precision Products muzzle brake for Mosin rifle	texas_precision_products_muzzlebrake_for_mosin_rifle
Compensator 2A "X3" 7.62x51 for AR-10	compensator_2a_x3_7.62x51_for_ar-10
Daniel Defense Wave Muzzle Brake 5.56x45	daniel_defense_wave_muzzle_brake_5.56x45
Carbine brake for SIG MPX by TACCOM	carbine_brake_for_sig_mpx_by_taccom
Surefire SF3P 5.56x45 Flash hider for AR-15	surefire_sf3p_5.56x45_flashhider_for_ar-15
KAC QD Compensator 5.56x45	kac_qd_compensator_5.56x45
DS Arms "3 prong trident" 7.62x51 Flash hider for SA-58	ds_arms_3_prong_trident_7.62x51_flashhider_for_sa-58
Izhmash 5.45x39 АK-105 muzzlebrake & compensator (6P44 0-20)	izhmash_5.45x39_аk-105_muzzlebrake_&_compensator_(6p44_0-20)
Izhmash 5.56x45 АK-102 muzzlebrake & compensator (6P44 0-20)	izhmash_5.56x45_аk-102_muzzlebrake_&_compensator_(6p44_0-20)
Thunder Beast 223CB Muzzle Brake 5.56x45	thunder_beast_223cb_muzzle_brake_5.56x45
TROY Claymore 5.56x45 muzzle brake for AR-15	troy_claymore_5.56x45_muzzle_brakefor_ar-15
Izhmash 7.62x39 АK-104 muzzlebrake & compensator (6P46 0-20)	izhmash_7.62x39_аk-104_muzzlebrake_&_compensator_(6p46_0-20)
AAC Blackout 51T 5.56x45 flash-hider	aac_blackout_51t_5.56x45_flash-hider
Phantom 7.62x51 muzzle brake & compensator for M14	phantom_7.62x51_muzzlebrake_&_compensator_for_m14
Tacfire Tanker style muzzle brake for Mosin rifle	tacfire_tanker_style_muzzlebrake_for_mosin_rifle
DVL-10 muzzle device	dvl-10_muzzle_device
Izhmash 5.45x39 RPK-16 muzzle brake & compensator	izhmash_5.45x39_rpk-16_muzzlebrake_&_compensator
SRVV 7.62x39 AK muzzle brake & compensator	srvv_7.62x39_ak_muzzlebrake_&_compensator
SRVV 5.45x39 AK-74 muzzle brake	srvv_5.45x39_ak-74_muzzlebrake
ASh-12 regular muzzle brake 12.7x55	ash-12_regular_muzzlebrake_12.7x55
Vortex DC 7.62x51 muzzle brake & compensator for M14	vortex_dc_7.62x51_muzzlebrake_&_compensator_for_m14
Thread adapter 7.62x54 for SV-98	thread_adapter_7.62x54_for_sv-98
TJ Custom 9x19 Compensator	tj_custom_9x19_compensator
Zenit DTK-1 7.62x39 & 5.45x39 muzzle brake & compensator for AK	zenit_dtk-1_7.62x39_&_5.45x39_muzzlebrake_&_compensator_for_ak
Orsis T-5000M muzzle brake	orsis_t-5000m_muzzle_break
AAC Blackout 51T flash hider (7.62x51)	aac_blackout_51t_flash_hider_(7.62x51)
Desert Tech 5.56x45 Flash hider	desert_tech_5.56x45_flashhider
Surefire WarComp 5.56x45 Flash hider for AR-15	surefire_warcomp_5.56x45_flashhider_for_ar-15
Izhmash 7.62x39 АK-103 muzzlebrake & compensator	izhmash_7.62x39_аk-103_muzzlebrake_&_compensator
Decelerator 3 Port 9x19 Compensator	decelerator_3_port_9x19_compensator
National Match 7.62x51 muzzle brake & compensator for M1A	national_match_7.62x51_muzzlebrake_&_compensator_for_m1a
DVL-10 M2 muzzle brake	dvl-10_m2_muzzle_break
PM-Laser DTK-TT muzzle brake for TT pistol	pm-laser_dtk-tt_muzzle_brake_for_tt_pistol
Izhmash 5.56x45 АK-101 muzzlebrake & compensator	izhmash_5.56x45_аk-101_muzzlebrake_&_compensator
HK A1 4.6x30 Flash hider for MP7	hk_a1_4.6x30_flashhider_for_mp7
Spike tactical dynacomp 7.62x39 muzzle brake & compensator for AK	spike_tactical_dynacomp_7.62x39_muzzlebrake_&_compensator_for_ak
Alpha Wolf Bullnose 9x19 Compensator	alpha_wolf_bullnose_9x19_compensator
Noveske KX3 5.56x45 flash hider	noveske_kx3_5.56x45_flashhider
 VPO-136 muzzle brake & compensator	molot_7.62x39_vepr_km___vpo-136_muzzlebrake_&_compensator
Lone Wolf Compensator 9 9x19	lone_wolf_compensator_9_9x19
FN P90 5.7x28 flash hider	fn_p90_5.7x28_flash_hider
DS Arms "Austrian Style" 7.62x51 muzzle brake for SA-58	ds_arms_austrian_style_7.62x51_muzzle_brake_for_sa-58
Izhmash 7.62x54 SVDS muzzlebrake & compensator	izhmash_7.62x54_svds_muzzlebrake_&_compensator
ADAR 2-15.56x45 Flashhider	adar_2-15.56x45_flashhider
SV-98 muzzle device	sv-98_muzzle_device
Colt USGI A2 5.56x45 Flash hider for AR-15	colt_usgi_a2_5.56x45_flashhider_for_ar-15
Taktika Tula AK and AKM adapter	taktika_tula_ak_and_akm_adapter
Izhmash 5.45x39 АK-74M muzzle brake & compensator (6P20 0-20)	izhmash_5.45x39_аk-74m_muzzlebrake_&_compensator_(6p20_0-20)
A2 9x19 Flash hider for MPX	a2_9x19_flashhider_for_mpx
Izhmash 7.62x39 flash hider for AKML system	izhmash_7.62x39_flash_hider_for_akml_system
Izhmash 5.45x39 AK-74 muzzle brake & compensator (6P20 0-20)	izhmash_5.45x39_ak-74_muzzlebrake_&_compensator_(6p20_0-20)
Izhmash 5.45x39 muzzle brake for AKS-74U (6P26 0-20)	izhmash_5.45x39_muzzle_break_for_aks-74u_(6p26_0-20)
VPO-209	thread_protection_for_akm_vpo-209
Izhmash 7.62x39 AKM muzzle brake & compensator (6P1 0-14)	izhmash_7.62x39_akm_muzzlebrake_&_compensator_(6p1_0-14)
compensator	izhmash_9x19_saiga-9_muzzle_brake_compensator
Socom 16 7.62x51 muzzle brake & compensator for M1A (unthreaded)	socom_16_7.62x51_muzzlebrake_&_compensator_for_m1a_(unthreaded)
Socom 16 7.62x51 muzzle brake & compensator for M1A (threaded)	socom_16_7.62x51_muzzlebrake_&_compensator_for_m1a_(threaded)
REAP-IR scope eyecup	reap-ir_scope_eyecup
3.1	kac_long_panel_for_urx_3_3.1_fde
SV-98 anti-heat ribbon	sv-98_anti-heat_ribbon
3.1	kac_stopper_panel_for_urx_3_3.1
3.1	kac_short_panel_for_urx_3_3.1
Vulcan MG scope eyecup	vulcan_mg_scope_eyecup
Heat shield for SV-98 silencer	heat_shield_for_sv-98_silencer
1P59 scope eyecup	1p59_scope_eyecup
PSO scope eyecup	pso_scope_eyecup
USP-1 scope eyecup	usp-1_scope_eyecup
AGR-870 protection cap	agr-870_protection_cap
NSPU-M scope eyecup	nspu-m_scope_eyecup
Zev Tech sight mount cap	zev_tech_sight_mount_cap
Cobra Family Sights Shade	cobra_family_sights_shade
Direct Thread adapter for the Lantac Blast mitigation device.	direct_thread_adapter_for_the_lantac_blast_mitigation_device.
PP-91-01 Kedr-B muzzle thread piece	pp-91-01_kedr-b_muzzle_thread_piece
Thread protector for Alpha Wolf Glock barrels	thread_protector_for_alpha_wolf_glock_barrels
B&T adapter for MP9 regular suppressor.	b&t_adapter_for_mp9_regular_supressor.
Direct Thread Mount adapter for Gemtech ONE.	direct_thread_mount_adapter_for_gemtech_one.
Remington Tactical Choke 12ga	remington_tactical_choke_12ga
Direct Thread Mount adapter for Silencerco Hybrid 46.	direct_thread_mount_adapter_for_silencerco_hybrid_46.
Glock thread protector produced by Double Diamond	glock_thread_protector_produced_by_double_diamond
3 Lug thread protector	3_lug_thread_protector
3 Lug threaded protector	3_lug_threaded_protector
Tiger Rock Mosin rifle tread adapter	tiger_rock_mosin_rifle_tread_adapter
Rotor 43 thread adapter for SVD-S	rotor_43_thread_adapter_for_svd-s
GK-02 Muzzle Brake	gk-02_muzzle_brake
ME Cylinder muzzle adapter 12 ga	me_cylinder_muzzle_adapter_12_ga
Weapon Tuning Mosin rifle tread adapter	weapon_tuning_mosin_rifle_tread_adapter
Weapon Tuning SKS tread adapter	weapon_tuning_sks_tread_adapter
SilencerCo Salvo 12 thread adapter	silencerco_salvo_12_thread_adapter
Custom Mosin rifle thread adapter	custom_mosin_rifle_thread_adapter
VPO-215 thread protection cap	vpo-215_thread_protection_cap
Glock thread protector produced by Salient Arms	glock_thread_protector_produced_by_salient_arms
P226 thread protection cap	p226_thread_protection_cap
SOK-12 Protection tube	sok-12_protection_tube
M700 thread protection cap	m700_thread_protection_cap
M9A3 thread protection cap	m9a3_thread_protection_cap
URX-4 handguard for AR-10 and compatible	urx-4_handguard_for_ar-10_and_compatible
MP5k Polymer handguard	mp5k_polymer_handguard
5.45 Design "Aggressor" handguard for AK	5.45_design_aggressor_handguard_for_ak
VLTOR CMRD Keymod handguard for AK	vltor_cmrd_keymod_handguard_for_ak
Hexagon handguard for AK	hexagon_handguard_for_ak
DS Arms quad rail foregrip for SA-58	ds_arms_quad_rail_foregrip_for_sa-58
Izhmash RPK-16 regular handguard	izhmash_rpk-16_regular_handguard
B-10M foregrip and rail mount B-19	b-10m_foregrip_and_rail_mount_b-19
Magpul MOE AKM HAND GUARD for AK	magpul_moe_akm_hand_guard_(black)_for_ak
URX 3 8" handguard for AR15	urx_3_8_handguard_for_ar15
Noveske SWS N6 10.5 inch foregrip for AR-10-compatible systems	noveske_sws_n6_10.5_inch_foregrip_for_ar-10-compatible_systems
URX 3.1 10.75" handguard for AR15	urx_3.1_10.75_handguard_for_ar15
XRSU47SU Tactical Handguard for AKS-74U	xrsu47su_tactical_handguard_for_aks-74u
Strike industries TRAX 2	strike_industries_trax_2
CAA RS47 foregrip for AK-compatible systems	caa_rs47_foregrip_for_ak-compatible_systems
SAI 14.5" QD Rail foregrip for AR15	sai_14.5_qd_rail_foregrip_for_ar15
Daniel Defence RIS II 12.25 foregrip for AR-15-compatible systems	daniel_defence_ris_ii_12.25_foregrip_for_ar-15-compatible_systems
Midwest 4.5 inch M-LOK foregrip for MPX	midwest_4.5_inch_m-lok_foregrip_for_mpx
Desert Tech foregrip for MDR	desert_tech_foregrip_for_mdr
Orsis handguard for T-5000	orsis_handguard_for_t-5000
LOBAEV Arms DVL-10 M2 handguard	lobaev_arms_dvl-10_m2_handguard
Magpul MOE M870 forestock	magpul_moe_m870_forestock
Handguard MK 10 for use with AR-15 and compatible	handguard_mk_10_for_use_with_ar-15_and_compatible
Lancer OEM 14 inch M-LOK foregrip for MPX	lancer_oem_14_inch_m-lok_foregrip_for_mpx
Remington Arms handguard for a R11 RSASS	remington_arms_handguard_for_a_r11_rsass
CAA HX-5 MP5 handguard	caa_hx-5_mp5_handguard
Stngr Vypr 10" M-LOK foregrip for AR15	stngr_vypr_10_m-lok_foregrip_for_ar15
Strike industries TRAX 1 foregrip	strike_industries_trax_1_foregrip
Daniel Defence RIS II 9.5 foregrip for AR-15-compatible systems	daniel_defence_ris_ii_9.5_foregrip_for_ar-15-compatible_systems
Alfa Arms Goliaf AKS-74U Handguard	alfa_arms_goliaf_aks-74u_handguard
Troy Industries 13" M-LOK foregrip for 416A5	troy_industries_13_m-lok_foregrip_for_416a5
Vltor CASV FAS foregrip for FAL	vltor_casv_fas_foregrip_for_fal
Vltor CASV FAL foregrip for FAL	vltor_casv_fal_foregrip_for_fal
SOK-12 aluminum handguard MTU002 Long Top	sok-12_aluminum_handguard_mtu002_long_top
Handguard War Sport LVOA-C blk. for use with AR-15 and compatible	handguard_war_sport_lvoa-c_blk._for_use_with_ar-15_and_compatible
Strike Industries CRUX 15" M-LOK foregrip for 416A5	strike_industries_crux_15_m-lok_foregrip_for_416a5
Midwest 13.5" M-LOK foregrip for 416A5	midwest_13.5_m-lok_foregrip_for_416a5
Handguard War Sport LVOA-S blk. for use with AR-15 and compatible	handguard_war_sport_lvoa-s_blk._for_use_with_ar-15_and_compatible
Daniel Defence FDE RIS II FSP 9.5 foregrip for AR-15-compatible systems	daniel_defence_fde_ris_ii_fsp_9.5_foregrip_for_ar-15-compatible_systems
Magpul Zhukov-U HAND GUARD for AK	magpul_zhukov-u_hand_guard_(black)_for_ak
SAG MK1 Freefloat Chassis for SVD	sag_mk1_freefloat_chassis_for_svd
Magpul MOE SL mid length M-LOK foregrip for AR15	magpul_moe_sl_mid_length_m-lok_foregrip_for_ar15
Krebs Custom UFM Keymod System handguard for AKM	krebs_custom_ufm_keymod_system_handguard_for_akm
SAI 10" QD Rail foregrip for AR15	sai_10_qd_rail_foregrip_for_ar15
Noveske SWS N6 Split handguard for AR-10-compatible systems	noveske_sws_n6_split_handguard_for_ar-10-compatible_systems
Lone Star Ion Lite handguard for AR-15 and compatible	lone_star_ion_lite_handguard_for_ar-15_and_compatible
Custom plastic MP-133 forestock with mounts	custom_plastic_mp-133_forestock_with_mounts
Wooden CAF WASR 10-63 handguard	wooden_caf_wasr_10-63_handguard
HK MRS 14" keymod foregrip for 416A5	hk_mrs_14_keymod_foregrip_for_416a5
Magpul MOE SL carbine length M-LOK foregrip for AR15	magpul_moe_sl_carbine_length_m-lok_foregrip_for_ar15
HK extended quadrail handguard for 416-compatible systems	hk_extended_quadrail_handguard_for_416-compatible_systems
HK quadrail handguard with a flip-up sight for 416-compatible systems	hk_quadrail_handguard_with_a_flip-up_sight_for_416-compatible_systems
MP5 TL-99 Aluminum handguard	mp5_tl-99_aluminum_handguard
B-11 AKS-74U Handguard	b-11_aks-74u_handguard
TDI AKM-L handguard for AK	tdi_akm-l_handguard_for_ak
A*B Arms MOD X Gen.3 keymod handguard for M700	a*b_arms_mod_x_gen.3_keymod_handguard_for_m700
SOK-12 aluminum handguard MTU002 Short Top	sok-12_aluminum_handguard_mtu002_short_top
Zenit B-10 AK Handguard	zenit_b-10_ak_handguard
Midwest 9" M-LOK foregrip for 416A5	midwest_9_m-lok_foregrip_for_416a5
PTR Tri-Rail MP5 handguard	ptr_tri-rail_mp5_handguard
HK quadrail handguard for 416-compatible systems	hk_quadrail_handguard_for_416-compatible_systems
Aim sport Universal M-LOK foregrip for FAL	aim_sport_universal_m-lok_foregrip_for_fal
Polymer ASh-12 foregrip	polymer_ash-12_foregrip
Polymer SVDS handguard	polymer_svds_handguard
Midwest 10.5 inch M-LOK foregrip for MPX	midwest_10.5_inch_m-lok_foregrip_for_mpx
Knight's Armament KAC RIS handguard for AR-15 and compatibles	knight's_armament_kac_ris_handguard_for_ar-15_and_compatibles
Aim sport Universal keymod foregrip for FAL	aim_sport_universal_keymod_foregrip_for_fal
Handguard SIG MPX Gen. 1 for MPX	handguard_sig_mpx_gen._1_for_mpx
ADAR 2-15 wooden stock for AR-15 and compatibles	adar_2-15_wooden_stock_for_ar-15_and_compatibles
MP5SD Polymer handguard	mp5sd_polymer_handguard
DSA Belgian style foregrip for a FAL	dsa_belgian_style_foregrip_for_a_fal
Midwest 6.5 inch M-LOK foregrip for MPX	midwest_6.5_inch_m-lok_foregrip_for_mpx
SOK-12 polymer handguard Sb.7-1	sok-12_polymer_handguard_sb.7-1
Colt M4 Length handguard for AR-15 and compatibles	colt_m4_length_handguard_for_ar-15_and_compatibles
Polymer AK-100 series foregrip	polymer_ak-100_series_foregrip
Fab Defence PR870 forestock	fab_defence_pr870_forestock
Polymer AK-74 foregrip (6P20 Sb.9)	polymer_ak-74_foregrip_(6p20_sb.9)
Wooden AK-74 handguard (6P1 Sb.6-1)	wooden_ak-74_handguard_(6p1_sb.6-1)
 VPO-209 handguard	wooden_akm___vpo-209_handguard
Wooden VPO-136 handguard	wooden_vpo-136_handguard
Wooden AK-74 handguard (6P20 Sb.6)	wooden_ak-74_handguard_(6p20_sb.6)
Wooden AKS-74U Handguard (6P26 Sb.6)	wooden_aks-74u_handguard_(6p26_sb.6)
MP5 Wide Tropical Polymer handguard	mp5_wide_tropical_polymer_handguard
Speedfeed short M870 forestock	speedfeed_short_m870_forestock
Original Austrian foregrip for a FAL	original_austrian_foregrip_for_a_fal
Izhmekh MP-133 Beechwood forestock	izhmekh_mp-133_beechwood_forestock
Izhmekh MP-153 Polymer stock	izhmekh_mp-153_polymer_stock
Strike Industries Viper carbine length M-LOK foregrip for AR-15	strike_industries_viper_carbine_length_m-lok_foregrip_for_ar-15
Magpul MOE AKM HAND GUARD for AK	magpul_moe_akm_hand_guard_(flat_dark_earth)_for_ak
Magpul MOE AKM HAND GUARD for AK	magpul_moe_akm_hand_guard_(olive_drab)_for_ak
Magpul MOE AKM HAND GUARD for AK	magpul_moe_akm_hand_guard_(plum)_for_ak
Magpul MOE AKM HAND GUARD for AK	magpul_moe_akm_hand_guard_(stealth_gray)_for_ak
Magpul Zhukov-U HAND GUARD (FDE) for AK	magpul_zhukov-u_hand_guard_(fde)_for_ak
Magpul Zhukov-U HAND GUARD (Plum) for AK	magpul_zhukov-u_hand_guard_(plum)_for_ak
16 inch .308 barrel for MDR and compatible	16_inch_.308_barrel_for_mdr_and_compatible
Barrel for Five-seveN 5.7x28	barrel_for_five-seven_5.7x28
Threaded barrel for Five-seveN 5.7x28	threaded_barrel_for_five-seven_5.7x28
406mm barrel for MDR and compatible 5.56x45	406mm_barrel_for_mdr_and_compatible_5.56x45
660mm .308 barrel for T-5000	660mm_.308_barrel_for_t-5000
Threaded barrel for Glock 9x19 manufactured by Salient Arms	threaded_barrel_for_glock_9x19_manufactured_by_salient_arms
18" barrel for AR-15 and compatible 5.56x45	18_barrel_for_ar-15_and_compatible_5.56x45
20" barrel for SR-25 and compatible 7.62x51	20_barrel_for_sr-25_and_compatible_7.62x51
Threaded barrel for Glock 9x19 manufactured by Lone Wolf.	threaded_barrel_for_glock_9x19_manufactured_by_lone_wolf.
10.6" barrel for 416A5 and compatible 5.56x45	10.6_barrel_for_416a5_and_compatible_5.56x45
16.5" barrel for 416A5 and compatible 5.56x45	16.5_barrel_for_416a5_and_compatible_5.56x45
508mm barrel for M870 12ga	508mm_barrel_for_m870_12ga
116mm 7.62x25 TT gilded barrel	116mm_7.62x25_tt_gilded_barrel
Threaded barrel for Glock 9x19 manufactured by Double Diamond	threaded_barrel_for_glock_9x19_manufactured_by_double_diamond
10.5" barrel for P90 5.7x28	10.5_barrel_for_p90_5.7x28
20" barrel for 416A5 and compatible 5.56x45	20_barrel_for_416a5_and_compatible_5.56x45
4.5" 9x19 barrel for MPX	4.5_9x19_barrel_for_mpx
20" barrel for AR-15 and compatible 5.56x45	20_barrel_for_ar-15_and_compatible_5.56x45
260mm barrel for AR-15 and compatible 5.56x45	260mm_barrel_for_ar-15_and_compatible_5.56x45
Threaded barrel for P226 9x19	threaded_barrel_for_p226_9x19
16" barrel for SA-58 7.62x51	16_barrel_for_sa-58_7.62x51
20" stainless steel barrel for a Remington M700 7.62x51 NATO	20_stainless_steel_barrel_for_a_remington_m700_7.62x51_nato
16" barrel for P90 5.7x28	16_barrel_for_p90_5.7x28
26" stainless steel barrel for a Remington M700 7.62x51 NATO	26_stainless_steel_barrel_for_a_remington_m700_7.62x51_nato
15" barrel for RPK-16 and compatible 5.45x39	15_barrel_for_rpk-16_and_compatible_5.45x39
11" barrel for SA-58 7.62x51	11_barrel_for_sa-58_7.62x51
660mm .308 barrel for DVL-10 M2	660mm_.308_barrel_for_dvl-10_m2
22" barrel for a SVDS 7.62x54	22_barrel_for_a_svds_7.62x54
22" barrel for a AR-10 and compatible 7.62x51 NATO	22_barrel_for_a_ar-10_and_compatible_7.62x51_nato
11" barrel for 416A5 and compatible 5.56x45	11_barrel_for_416a5_and_compatible_5.56x45
22" barrel for RPK-16 and compatible 5.45x39	22_barrel_for_rpk-16_and_compatible_5.45x39
18" barrel for a AR-10 and compatible 7.62x51 NATO	18_barrel_for_a_ar-10_and_compatible_7.62x51_nato
500mm .308 barrel for DVL-10	500mm_.308_barrel_for_dvl-10
10.5" 9x19 barrel for MPX	10.5_9x19_barrel_for_mpx
14.5" barrel for 416A5 and compatible 5.56x45	14.5_barrel_for_416a5_and_compatible_5.56x45
21" barrel for SA-58 7.62x51	21_barrel_for_sa-58_7.62x51
22" barrel for a M1A 7.62x51 NATO	22_barrel_for_a_m1a_7.62x51_nato
16" barrel for SR-25 and compatible 7.62x51	16_barrel_for_sr-25_and_compatible_7.62x51
26" barrel for a Remington M700 7.62x51 NATO	26_barrel_for_a_remington_m700_7.62x51_nato
14" 9x19 barrel for MPX	14_9x19_barrel_for_mpx
Regular 730mm Mosin barrel	regular_730mm_mosin_barrel
Barrel with compensator for Glock 17 9x19	barrel_with_compensator_for_glock_17_9x19
660mm vent rib barrel for M870 12ga	660mm_vent_rib_barrel_for_m870_12ga
Sawn off 220mm Mosin barrel	sawn_off_220mm_mosin_barrel
370mm barrel for AR-15 and compatible 5.56x45	370mm_barrel_for_ar-15_and_compatible_5.56x45
20" barrel for a Remington M700 7.62x51 NATO	20_barrel_for_a_remington_m700_7.62x51_nato
6.5" 9x19 barrel for MPX	6.5_9x19_barrel_for_mpx
Cut off 325mm barrel for M870 12ga	cut_off_325mm_barrel_for_m870_12ga
355mm barrel for M870 12ga	355mm_barrel_for_m870_12ga
16" barrel for a M1A 7.62x51 NATO	16_barrel_for_a_m1a_7.62x51_nato
610 mm barrel for MP-153 12ga shotgun	610_mm_barrel_for_mp-153_12ga_shotgun
406mm Molot barrel for AR-15 and compatible 5.56x45	406mm_molot_barrel_for_ar-15_and_compatible_5.56x45
Homespun 121mm 7.62x25 TT barrel with threading	homespun_121mm_7.62x25_tt_barrel_with_threading
510mm barrel for MP-133 12ga	510mm_barrel_for_mp-133_12ga
510mm barrel for MP-133 12ga shotgun with rib	510mm_barrel_for_mp-133_12ga_shotgun_with_rib
540mm barrel for MR-133 12ga shotgun with rib	540mm_barrel_for_mr-133_12ga_shotgun_with_rib
750mm barrel for MP-133 12ga shotgun with rib	750mm_barrel_for_mp-133_12ga_shotgun_with_rib
Basic barrel for Glock 17 9x19	basic_barrel_for_glock_17_9x19
710mm barrel for MP-133 12ga shotgun	710mm_barrel_for_mp-133_12ga_shotgun
Sawn off 200mm Mosin barrel	sawn_off_200mm_mosin_barrel
540mm barrel for MP-133 12ga shotgun	540mm_barrel_for_mp-133_12ga_shotgun
610mm barrel for MP-133 12ga shotgun with rib	610mm_barrel_for_mp-133_12ga_shotgun_with_rib
165 mm 9x19 barrel for MPX-SD	165_mm_9x19_barrel_for_mpx-sd
660 mm barrel for MP-153 12ga shotgun	660_mm_barrel_for_mp-153_12ga_shotgun
Regular 514mm Mosin carbine barrel	regular_514mm_mosin_carabine_barrel
660mm barrel for MR-133 12ga shotgun	660mm_barrel_for_mr-133_12ga_shotgun
112mm barrel for P226 9x19	112mm_barrel_for_p226_9x19
710 mm barrel for MP-153 12ga shotgun	710_mm_barrel_for_mp-153_12ga_shotgun
750mm barrel for MP-133 12ga shotgun	750mm_barrel_for_mp-133_12ga_shotgun
710mm barrel for MR-133 12ga shotgun with rib	710mm_barrel_for_mr-133_12ga_shotgun_with_rib
660mm barrel for MP-133 12ga shotgun with rib	660mm_barrel_for_mp-133_12ga_shotgun_with_rib
610mm barrel for MP-133 12ga shotgun	610mm_barrel_for_mp-133_12ga_shotgun
750 mm barrel for MP-153 12ga shotgun	750_mm_barrel_for_mp-153_12ga_shotgun
508mm barrel for M870 12ga with a fixed sight	508mm_barrel_for_m870_12ga_with_a_fixed_sight
23" barrel for a VPO-215 .366TKM	23_barrel_for_a_vpo-215_.366tkm
203 mm 9x19 barrel for MPX	203_mm_9x19_barrel_for_mpx
116mm 7.62x25 TT barrel	116mm_7.62x25_tt_barrel
Barrel with compensator for Glock 18C 9x19	barrel_with_compensator_for_glock_18c_9x19
Threaded barrel for M9A3 9x19	threaded_barrel_for_m9a3_9x19
Tactica Tula 10000 mount	tactica_tula_10000_mount
Orsis long length rail	orsis_long_lenght_rail
Orsis scope mount for T-5000M	orsis_scope_mount_for_t-5000m
B&T MP5 SD Tri Rail Ring Mount	b&t_mp5_sd_tri_rail_ring_mount
M14 Ultimak M8 upper part	m14_ultimak_m8_upper_part
Trijicon RMR mount for a Sig-Sauer pistols	trijicon_rmr_mount_for_a_sig-sauer_pistols
SVD Low sidemount	svd_low_sidemount
M14 UTG 4 point locking deluxe mount	m14_utg_4_point_locking_deluxe_mount
SR1MP quad rail mount	sr1mp_quad_rail_mount
MFI HK Universal Low Profile Scope Mount	mfi_hk_universal_low_profile_scope_mount
B-13V rail platform above reciever "Classic"	b-13v_rail_platform_above_reciever_classic
30mm ring-mount made by JP	30mm_ring-mount_made_by_jp
B-13 rail platform	b-13_rail_platform
Trijicon RMR mount for ACOG scopes	trijicon_rmr_mount_for_acog_scopes
UTG SKS SOCOM Rail mount	utg_sks_socom_rail_mount
UNV DLOC-IRD Mount for sights	unv_dloc-ird_mount_for_sights
TA51 Mount for sights	ta51_mount_for_sights
30mm ring-mount AR- P.E.P.R. made by Burris	30mm_ring-mount_ar-_p.e.p.r._made_by_burris
TOZ 6P29M Mount	toz_6p29m_mount
UM Tactical UM3 Sight Mount	um_tactical_um3_sight_mount
34mm one piece magmount made by Nightforce	34mm_one_piece_magmount_made_by_nightforce
Aimtech Tiger Shark	aimtech_tiger_shark
Short length rail for Hexagon	short_length_rail_for_hexagon
B-3 mount combo	b-3_mount_combo
B-3 mount	b-3_mount
CASV 14 mount for M14	casv_14_mount_for_m14
Dovetail OP-SKS mount.	dovetail_op-sks_mount.
Aimpoint mount for the sights of Micro series	aimpoint_mount_for_the_sights_of_micro_series
Orsis medium length rail	orsis_medium_lenght_rail
Arbalet Patriot K+W mount	arbalet_patriot_k w_mount
Axion Cobra mount	axion_cobra_mount
Mesa Tactical magazine clamp for M870	mesa_tactical_magazine_clamp_for_m870
SVDS Upper Band	svds_upper_band
34mm one piece magmount made by I-E-A Mil Optics	34mm_one_piece_magmount_made_by_i-e-a_mil_optics
Aimtech glock base	aimtech_glock_base
SR1MP silencer mount	sr1mp_silencer_mount
Standard Spacer for Aimpont sight	standart_spacer_for_aimpont_sight
Pilad 043-02 Mount	pilad_043-02_mount
M14 Mini Scout mount	m14_mini_scout_mount
Aim Sports MNG rail for Mosin rifle	aim_sports_mng_rail_for_mosin_rifle
Bridge Sight Mount for P226	bridge_sight_mount_for_p226
Sig Sauer mount for the sights of Romeo series.	sig_sauer_mount_for_the_sights_of_romeo_series.
Aimpoint LRP mount for COMP M4 sights.	aimpoint_lrp_mount_for_comp_m4_sights.
Troy QARS 3.2 inch guide	troy_qars_3.2_inch_guide
M14 DCSB	m14_dcsb
Izhmash RPK-16 rail	izhmash_rpk-16_rail
Vltor CASV keymod 6 inch guide	vltor_casv_keymod_6_inch_guide
XS Short rail with Ghost ring for M870	xs_short_rail_with_ghost_ring_for_m870
Arms 18 mount for M14	arms_18_mount_for_m14
Kiba Arms International SPRM mount for pump-action shotguns	kiba_arms_international_sprm_mount_for_pump-action_shotguns
La Rue Tactical picatinny riser QD LT-101 mount	la_rue_tactical_picatinny_riser_qd_lt-101_mount
34mm one piece magmount made by Nightforce with a Multimount rail	34mm_one_piece_magmount_made_by_nightforce_with_a_multimount_rail
Aimpoint Micro Spacer High	aimpoint_micro_spacer_high
A*B Arms MOD X mount for M700	a*b_arms_mod_x_mount_for_m700
30mm rings made by Nightforce	30mm_rings_made_by_nightforce
SR1MP single rail mount	sr1mp_single_rail_mount
Troy QARS 4.2 inch guide	troy_qars_4.2_inch_guide
Alexander Arms 10 inch guide	alexander_arms_10_inch_guide
Cross Slot Mount base for Deltapoint scopes	cross_slot_mount_base_for_deltapoint_scopes
Armasight universal base	armasight_universal_base
Magpul M-LOK 2.5 inch guide	magpul_m-lok_2.5_inch_guide
Aim Sports "Tri-Rail" rail for Mosin rifle	aim_sports_tri-rail_rail_for_mosin_rifle
Low profile mount for Trijicon RMR	low_profile_mount_for_trijicon_rmr
B-18 Mount	b-18_mount
High profile mount for Trijicon RMR	high_profile_mount_for_trijicon_rmr
TOZ-106 scope mount	toz-106_scope_mount
NcStar MPR45 Backup mount	ncstar_mpr45_backup_mount
SIG MPX Gen1 Handguard 4 inch rail adapter	sig_mpx_gen1_handguard_4_inch_rail_adapter
30mm Scope mount	30mm_scope_mount
Strike industries keymod 6 inch guide	strike_industries_keymod_6_inch_guide
B&T 3x rail mount for MP5	b&t_3x_rail_mount_for_mp5
Vltor CASV keymod 4 inch guide	vltor_casv_keymod_4_inch_guide
Dovetail mount for TOZ-106	dovetail_mount_for_toz-106
25 mm mount ring	25_mm_mount_ring
153	stock_adapter_tactica_tula_12003_for_mp-133_153
KAC URX 3 inch guide	kac_urx_3_inch_guide
Vltor CASV keymod 2 inch guide	vltor_casv_keymod_2_inch_guide
Magpul M-LOK 4.1 inch guide	magpul_m-lok_4.1_inch_guide
Rotor 43 RIS mount for PP Kedr	rotor_43_ris_mount_for_pp_kedr
B-12 Mount	b-12_mount
Delta-tek Sprut mount for pump-action shotguns	delta-tek_sprut_mount_for_pump-action_shotguns
FN RMR Mount for 5-7 Mk.2	fn_rmr_mount_for_5-7_mk.2
M1A Socom 16 upper part	m1a_socom_16_upper_part
KMZ 1P59 Dovetail mount	kmz_1p59_dovetail_mount
FN EFFEN 90 rail	fn_effen_90_rail
Vltor CASV 5 inch guide	vltor_casv_5_inch_guide
30mm ring-mount Remington integral for model 700 rifles	30mm_ring-mount_remington_integral_for_model_700_rifles
Alexander Arms 3 inch guide	alexander_arms_3_inch_guide
Medium length rail for Hexagon	medium_length_rail_for_hexagon
Remington RAHG 4 inch guide	remington_rahg_4_inch_guide
Burris FastFire Weaver Base	burris_fastfire_weaver_base
Vltor CASV 2 inch guide	vltor_casv_2_inch_guide
SIG MPX Gen1 Handguard 2 inch rail adapter	sig_mpx_gen1_handguard_2_inch_rail_adapter
Vltor CASV 4 inch guide	vltor_casv_4_inch_guide
Kochetov Mount for Mosin rifle	kochetov_mount_for_mosin_rifle
FN side rail for regular P90 upper receiver	fn_side_rail_for_regular_p90_upper_receiver
25mm rings made by UTG	25mm_rings_made_by_utg
Remington RAHG 2 inch guide	remington_rahg_2_inch_guide
Magpul inline mount for PRO 700 chassis	magpul_inline_mount_for_pro_700_chassis
Weaver extended multi-slot base for Remington model 700	weaver_extended_multi-slot_base_for_remington_model_700
Strike industries keymod 4 inch guide	strike_industries_keymod_4_inch_guide
FN top rail for regular P90 upper receiver	fn_top_rail_for_regular_p90_upper_receiver
B&T MP9 bottom rail	b&t_mp9_bottom_rail
Compact mount for sights	compact_mount_for_sights
Scope mount for VPO-215	scope_mount_for_vpo-215
PU 3.5x ring mount	pu_3.5x_ring_mount
Strike industries bridge guide	strike_industries_bridge_guide
KMZ 1P69 Weaver mount	kmz_1p69_weaver_mount
B-8 mount	b-8_mount
B&T MP9 side rail	b&t_mp9_side_rail
MTU-028SG rail for M870	mtu-028sg_rail_for_m870
Sawn off Mosin rifle sniper stock	sawn_off_mosin_rifle_sniper_stock
Orsis Aluminium body for T-5000	orsis_aluminium_body_for_t-5000
Regular stock for B&T MP9	regular_stock_for_b&t_mp9
Troy S.A.S.S. Chassis stock for M14	troy_s.a.s.s._chassis_stock_for_m14
DSA SPR stock for SA-58	dsa_spr_stock_for_sa-58
Regular stock for HK MP7A1	regular_stock_for_hk_mp7a1
Zhukov-S for AK	zhukov-s_for_ak
LOBAEV Arms Stock	lobaev_arms_stock
HK A3 old stock model	hk_a3_old_stock_model
Regular stock for HK MP7A2	regular_stock_for_hk_mp7a2
M1A Archangel stock	m1a_archangel_stock
M700 MOD X Gen.3 stock	m700_mod_x_gen.3_stock
Recoil pad from Aim Sports for Mosin rifle	recoil_pad_from_aim_sports_for_mosin_rifle
UBR GEN2 stock	ubr_gen2_black_stock
Fab Defense UAS for AK	fab_defense_uas_for_ak
Promag Archangel polymer stock for M700	promag_archangel_polymer_stock_for_m700
APB detachable wire stock	apb_detachable_wire_stock
Magpul PRS 2 polymer stock for FAL	magpul_prs_2polymer_stock_for_fal
Orsis T-5000M Stock	orsis_t-5000m_stock
AT AICS polymer stock for M700	at_aics_polymer_stock_for_m700
Fab Defence UAS Stock for SKS	fab_defence_uas_stock_for_sks
Magpul PRO 700 chassis	magpul_pro_700_chassis
153	plastic_pistol_grip_for_mp-133_153
HK A2 Stock	hk_a2_stock
HK E1 Stock for AR-15 and compatible	hk_e1_stock_for_ar-15_and_compatable
ProMag Archangel OPFOR PRS Mosin rifle stock	promag_archangel_opfor_prs_mosin_rifle_stock
Hogue "Overmolded ghillie" stock for Remington Model 700	hogue_overmolded_ghillie_stock_for_remington_model_700
Zenit PT-3 "Klassika" stock	zenit_pt-3_klassika_stock
Polymer stock for SVDS	polymer_stock_for_svds
Magpul PRS GEN3 stock	magpul_prs_gen3_stock
Zenit PT-1 "Klassika" stock	zenit_pt-1_klassika_stock
SIG retractable stock pipe adapter	sig_retractable_stock_pipe_adapter
Fab Defence GLR-17 Stock for Glock and compatible	fab_defence_glr-17_stock_for_glock_and_compatable
ME adapter for AK	me_adapter_for_ak
M1A Socom 16 stock	m1a_socom_16_stock
Damage Industries Butt-pad for P90	damage_industries_butt-pad_for_p90
Fab Defence GL Shock Stock	fab_defence_gl_shock_stock
MFT BUS Stock	mft_bus_stock
Double Star recoil pad 0.5 for ACE stock series	double_star_recoil_pad_0.5_for_ace_stock_series
SGA stock for M870	sga_stock_for_m870
Magpul CTR Carbine stock	magpul_ctr_carbine_stock
M14 M14ALCS(MOD. 0) stock	m14_m14alcs(mod._0)_stock
DSA Folding stock for SA-58	dsa_folding_stock_for_sa-58
SI Viper Mod.1 Stock	si_viper_mod.1_stock
Magpul Rubber Butt-Pad for Carbine stock series	magpul_rubber_butt-pad_for_carbine_stock_series
IzhMash metal stock for AKS-74 (6P21 Sb.5)	izhmash_metal_stock_for_aks-74_(6p21_sb.5)
153	plastic_stock_for_mp-133_153
M14 M14ALCS(MOD. 0) stock (buttstock)	m14_m14alcs(mod._0)_stock_(buttstock)
F93 Pro Stock	f93_pro_stock
DSA BRS stock for SA-58	dsa_brs_stock_for_sa-58
AKS-74U PT Lock	aks-74_aks-74u_pt_lock
Double Star Ace Socom gen.4 stock for AR-15	double_star_ace_socom_gen.4_stock_for_ar-15
Izhmash shoulder piece for AKMSN (6P4 Sb.1-19)	izhmash_shoulder_piece_for_akmsn_(6p4_sb.1-19)
ATI Monte Carlo Mosin rifle stock	ati_monte_carlo_mosin_rifle_stock
AK-74 PT Lock	akm_ak-74_pt_lock
Buffer tube side folder adapter for M700	buffer_tube_side_folder_adapter_for_m700
Magpul PRS GEN2 FDE stock	magpul_prs_gen2_fde_stock
CAA AKTS AK-74 Buffer Tube for AK and compatible	caa_akts_ak-74_buffer_tube_for_ak_and_compatible
EMOD Stock	emod_stock
Tapco INTRAFUSE Stock for SKS	tapco_intrafuse_stock_for_sks
Recoil pad from GP-25 for AK Accessory Kit	recoil_pad_from_gp-25_for_ak_accessory_kit
SI Advanced receiver extension buffer tube	si_advanced_receiver_extension_buffer_tube_(black)
COLT "A2" buffer tube	colt_a2_buffer_tube
CAA AKTS AK-74 Buffer Tube for AK and compatible (foldable)	caa_akts_ak-74_buffer_tube_for_ak_and_compatable_(foldable)
PRO 700 folding stock	pro_700_folding_stock
FN P90 stock	fn_p90_stock
HK End Cap Stock for MP5	hk_end_cap_stock_for_mp5
HK End Cap Stock for MP5 Kurz	hk_end_cap_stock_for_mp5_kurz
Buffer Tube adapter for SA-58	buffer_tube_adapter_for_sa-58
Izhmash AK-12 regular stock	izhmash_ak-12_regular_stock
FN Butt pad for P90	fn_butt_pad_for_p90
Fab Defence GLR-16-S Stock	fab_defence_glr-16-s_stock
MOE Carbine stock	moe_carbine_stock
Izhmash shoulder piece for AKMS (6P4 Sb.1-19)	izhmash_shoulder_piece_for_akms_(6p4_sb.1-19)
MPX stock	maxim_defence_cqb_collapsing_telescoping_mcx_mpx_stock
Troy M7A1 PDW stock	troy_m7a1_pdw_stock
AK100 PT Lock	ak74_ak100_pt_lock
MPX stock	pmm_ulss_foldable_mcx_mpx_stock
MPX stock	early_produced_sig_collapsing_telescoping_mcx_mpx_stock
LMT Sopmod stock	lmt_sopmod_stock
Regular VPO-101 "Vepr Hunter" stock	regular_vpo-101_vepr_hunter_stock
HK "Enhanced Tube" buffer tube	hk_enhanced_tube_buffer_tube
Wooden stock for Molot OP-SKS	wooden_stock_for_molot_op-sks
HK Slim Line Stock	hk_slim_line_stock
Metal Izhmash stock for PP-19-01	metal_izhmash_stock_for_pp-19-01
Custom cut mosin stock for TOZ-106	custom_cut_mosin_stock_for_toz-106
Izhmash RPK-16 buffer tube	izhmash_rpk-16_buffer_tube
FN PS90 stock	fn_ps90_stock
Mosin rifle sniper carbine stock	mosin_rifle_sniper_carbine_stock
ADAR 2-15 wooden stock	adar_2-15_wooden_stock
High Standard M4SS Stock	high_standard_m4ss_stock
LEO stock adapter for M870	leo_stock_adapter_for_m870
Remington SPS Polymer stock for M870	remington_sps_polymer_stock_for_m870
Polymer stock DSA humpback for SA-58	polymer_stock_dsa_humpback_for_sa-58
Raptor grip for M870	raptor_grip_for_m870
Izhmash wooden AKM stock (6P1 Sb.5)	izhmash_wooden_akm_stock_(6p1_sb.5)
Mosin carbine stock	mosin_carbine_stock
153	wooden_stock_for_mp-133_153
Molot wooden VPO-209 stock	molot_wooden_vpo-209_stock
Izhmash polymer AK-74 stock (6P20 Sb.7)	izhmash_polymer_ak-74_stock_(6p20_sb.7)
Regular Mosin rifle stock	regular_mosin_rifle_stock
Armacon Baskak stock	armacon_baskak_stock
Molot wooden VPO-136 stock	molot_wooden_vpo-136_stock
Wooden stock 56-A-231 Sb.5	wooden_stock_56-a-231_sb.5
TSNIITochMash VSS Vintorez stock	tsniitochmash_vss_vintorez_stock
TSNIITochMash AS VAL stock	tsniitochmash_as_val_stock
ADAR buffer tube	adar_buffer_tube
Polymer stock for AK-74M (6P34 Sb.15)	polymer_stock_for_ak-74m_(6p34_sb.15)
Fab Defence buffer tube for AGR-870	fab_defence_buffer_tube_for_agr-870
Tapco buffer tube	tapco_buffer_tube
Sawn off regular Mosin rifle stock	sawn_off_regular_mosin_rifle_stock
Regular VPO-215 stock	regular_vpo-215_stock
Izhmash metal stock for AKS-74U (6P26 Sb.5)	izhmash_metal_stock_for_aks-74u_(6p26_sb.5)
MC 20-01 stock	mc_20-01_stock
Izhmash SOK-12 AK type stock	izhmash_sok-12_ak_type_stock
Izhmash wooden AK-74 stock (6P20 Sb.5)	izhmash_wooden_ak-74_stock_(6p20_sb.5)
Colt buffer tube	colt_buffer_tube
Infantry Mosin rifle stock	infantry_mosin_rifle_stock
TOZ stock for TOZ-106	toz_stock_for_toz-106
UBR GEN2 FDE stock	ubr_gen2_fde_stock
Troy M7A1 PDW FDE stock	troy_m7a1_pdw_fde_stock
Harris HBR Bipod	harris_hbr_bipod
Izhmash SV-98 bipod	izhmash_sv-98_bipod
M9A3 Standard Frontsight	m9a3_standard_frontsight
APS Frontsight	aps_frontsight
Beretta M9A3 Standard Rearsight	beretta_m9a3_standard_rearsight
M14 Enlarged Military Aperture Rearsight	m14_enlarged_military_aperture_rearsight
KAC Folding micro sight Rear	kac_folding_micro_sight_rear
Five-seveN Standard Rear-sight	five-seven_standard_rear-sight
Sight Mount Sig 220-239 rear sight bearing	sight_mount_sig_220-239_rear_sight_bearing
Sig Sauer P226 Standard Rearsight	sig_sauer_p226_standard_rearsight
Sight Mount M9 rear sight bearing	sight_mount_m9_rear_sight_bearing
Five-seveN MK2 Standard Frontsight	five-seven_mk2_standard_frontsight
SIG Flip Up Frontsight	sig_flip_up_frontsight
SIG Flip Up Rearsight	sig_flip_up_rearsight
B&T MP9 Standard Rear-sight	b&t_mp9_standard_rear-sight
HK MP5 Drum Rearsight	hk_mp5_drum_rearsight
Dead Ringer Snake Eye Glock rear sight	dead_ringer_snake_eye_glock_rear_sight
Trijicon ACOG backup rear sight	trijicon_acog_backup_rear_sight
SA XS Post .125 blade Frontsight M1A	sa_xs_post_.125_blade_frontsight_m1a
KAC Folding sight Rear	kac_folding_sight_rear
KAC Folding micro sight Frontsight	kac_folding_micro_sight_frontsight
MP7 Flip Up Rearsight	mp7_flip_up_rearsight
HK 416A5 Flip Up Rearsight	hk_416a5_flip_up_rearsight
Tactica Tula TT01 Rearsight Weaver Adapter	tactica_tula_tt01_rearsight_weaver_adapter
KAC Folding sight Frontsight	kac_folding_sight_frontsight
VPO-101 Standard Rearsight	vpo-101_standard_rearsight
Glock ZEV Tech Rear sight	glock_zev_tech_rear_sight
VSS Vintorez Standard Rearsight	vss_vintorez_standard_rearsight
ASh-12 Folding sight Frontsight	ash-12_folding_sight_frontsight
Rearsight AR-15 Carry Handle	rearsight_ar-15_carry_handle
SOK-12 CSS SIGHT RAIL MOUNT rear sight	sok-12_css_sight_rail_mount_rear_sight
Magpul MBUS Gen.2 Rearsight	magpul_mbus_gen.2_rearsight
Rearsight ASh-12 Carry Handle	rearsight_ash-12_carry_handle
SA National Match .062 blade Frontsight M1A	sa_national_match_.062_blade_frontsight_m1a
Meprolight "Tru Dot Night Sight" Frontsight for P226	meprolight_tru_dot_night_sight_frontsight_for_p226
Dead Ringer Snake Eye Glock front sight	dead_ringer_snake_eye_glock_front_sight
Meprolight Tru Dot Night Sight rear sight for P226	meprolight_tru_dot_night_sight_rear_sight_for_p226
AK-105 Standard Rearsight (6P44 Sb.1-30)	ak-105_standard_rearsight_(6p44_sb.1-30)
Izhmash SV-98 Rearsight	izhmash_sv-98_rearsight
MP7 Flip Up Frontsight	mp7_flip_up_frontsight
AKMP system rear sight device	akmp_system_rear_sight_device
Magpul MBUS Gen.2 Frontsight	magpul_mbus_gen.2_frontsight
AS VAL Standard rear sight	as_val_standard_rear_sight
Truglo TFX Glock front sight	truglo_tfx_glock_front_sight
AKMP system front sight device	akmp_system_front_sight_device
Glock Front Sight	glock_front_sight
Truglo TFX Glock rear sight	truglo_tfx_glock_rear_sight
SVDS Rearsight	svds_rearsight
Mosin Rearsight	mosin_rearsight
Colt A2 Rearsight AR-15	colt_a2_rearsight_ar-15
Izhmash Rearsight base for RPK-16	izhmash_rearsight_base_for_rpk-16
Izhmash Rearsight for RPK-16	izhmash_rearsight_for_rpk-16
Mosin carbine Rearsight	mosin_carabine_rearsight
Mosin frontsight	mosin_frontsight
UTG Low Profile A2 Frontsight AR-15	utg_low_profile_a2_frontsight_ar-15
SVDS frontsight	svds_frontsight
AKMB system rear sight	akmb_system_rear_sight
 VPO-209 Standard Rearsight	akm___vpo-209_standard_rearsight
Izhmash SOK-12 rear sight	izhmash_sok-12_rear_sight
DS Arms Holand Type Rearsight for SA-58	ds_arms_holand_type_rearsight_for_sa-58
AK-74M Standard Rearsight (6P20 Sb.2)	ak-74m_standard_rearsight_(6p20_sb.2)
AK-74 Standard Rearsight (6P1 Sb.2)	ak-74_standard_rearsight_(6p1_sb.2)
Sig Sauer Standard Frontsight	sig_sauer_standard_frontsight
AKM Standard Rearsight (6P1 Sb.2-1)	akm_standard_rearsight_(6p1_sb.2-1)
SKS Standard Rearsight	sks_standard_rearsight
APB Rearsight	apb_rearsight
APS Rearsight	aps_rearsight
Glock ZEV Tech Front sight	glock_zev_tech_front_sight
Glock Rear Sight	glock_rear_sight
Izhmash rear sight for PP-19-01	izhmash_rear_sight_for_pp-19-01
USEC stash on Customs key	usec_stash_on_customs_key
K1S Visor	k1s_visor
Ops-Core FAST Visor	ops-core_fast_visor
TW EXFIL Ballistic helmet face shield (coyote)	tw_exfil_ballistic_helmet_face_shield_(coyote)
TW EXFIL Ballistic helmet face shield (black)	tw_exfil_ballistic_helmet_face_shield_(black)
VAZ key	vaz_key
Door key (alternative)	door_key_(alternative)
Door key	door_key
Bandana	bandana
BEAR baseball cap	bear_baseball_cap
BEAR baseball cap black	bear_baseball_cap_black
UX PRO Beanie	ux_pro_beanie
USEC baseball cap black	usec_baseball_cap_black
USEC baseball cap	usec_baseball_cap
Christmas tree decoration ball (red)	christmas_tree_decoration_ball_(red)
Christmas tree decoration ball (silver)	christmas_tree_decoration_ball_(silver)
Christmas tree decoration ball (violet)	christmas_tree_decoration_ball_(violet)
40-round PMAG GEN M3 FDE 40 5.56x45 STANAG magazine	40-round_pmag_gen_m3_fde_40_5.56x45_stanag_magazine
PMAG GEN M3 FDE W 30 5.56x45 STANAG 30-round magazine	pmag_gen_m3_fde_w_30_5.56x45_stanag_30-round_magazine
Metal magazine for VPO-215 and compatibles, .366 TKM 4-round capacity	metal_magazine_for_vpo-215_and_compatibles,_.366_tkm_4-round_capacity
SI Advanced receiver extension buffer tube (anodized red)	si_advanced_receiver_extension_buffer_tube_(anodized_red)
Magpul MBUS Gen.2 Frontsight FDE	magpul_mbus_gen.2_frontsight_fde
Magpul MBUS Gen.2 Rearsight FDE	magpul_mbus_gen.2_rearsight_fde
3.1 FDE	kac_stopper_panel_for_urx_3_3.1_fde
3.1 FDE	kac_short_panel_for_urx_3_3.1_fde
ETMI-019 Mount	etmi-019_mount
Medium length rail for Hexagon(Anodized Red)	medium_length_rail_for_hexagon(anodized_red)
TDI AKM-L handguard for AK Anodized Red	tdi_akm-l_handguard_for_ak_anodized_red
Hexagon handguard for AK(anodized red)	hexagon_handguard_for_ak(anodized_red)
TDI AKM-L handguard for AK Anodized Bronze	tdi_akm-l_handguard_for_ak_anodized_bronze
VS-24 white handguard with a VS-33c gas block combo for AK	vs-24_white_handguard_with_a_vs-33c_gas_block_combo_for_ak
DS Arms Quad Rail Full Length foregrip for SA-58	ds_arms_quad_rail_full_length_foregrip_for_sa-58
Shoreline paper map	shoreline_paper_map
Factory Plan	factory_plan
Customs plan	customs_plan
Woods Plan	woods_plan
Shoreline resort plan	shoreline_resort_plan
Interchange paper map	interchange_paper_map
Armband (blue)	armband_(blue)
Armband (green)	armband_(green)
Armband (red)	armband_(red)
Armband (white)	armband_(white)
Armband (yellow)	armband_(yellow)
Maska 1Sch face shield	maska_1sch_face_shield
Leatherman Multitool	leatherman_multitool
WIFI Camera	wifi_camera
Signal Jammer	signal_jammer
MS2000 Marker	ms2000_marker
40 mm VOG-25	40_mm_vog-25
Weapon safe key	weapon_safe_key
120 pcs. 5.45x39 BT gs ammo pack	120_pcs._5.45x39_bt_gs_ammo_pack
120 pcs. 5.45x39 PP gs ammo pack	120_pcs._5.45x39_pp_gs_ammo_pack
120 pcs. 5.45x39 PRS gs ammo pack	120_pcs._5.45x39_prs_gs_ammo_pack
120 pcs. 5.45x39 US gs ammo pack	120_pcs._5.45x39_us_gs_ammo_pack
16 pcs. 9x18 PM BZHT gzh ammo box	16_pcs._9x18_pm_bzht_gzh_ammo_box
16 pcs. 9x18 PM PBM ammo box	16_pcs._9x18_pm_pbm_ammo_box
16 pcs. 9x18 PM PMM ammo box	16_pcs._9x18_pm_pmm_ammo_box
16 pcs. 9x18 PM Ppe gzh ammo box	16_pcs._9x18_pm_ppe_gzh_ammo_box
16 pcs. 9x18 PM Pst gzh ammo box	16_pcs._9x18_pm_pst_gzh_ammo_box
16 pcs. 9x18 PM SP7 gzh ammo box	16_pcs._9x18_pm_sp7_gzh_ammo_box
16 pcs. 9x18 PM SP8 gzh ammo box	16_pcs._9x18_pm_sp8_gzh_ammo_box
20 pcs pack 5.56x45 Warmage ammo	20_pcs_pack_5.56x45_warmage_ammo
30 pcs. 5.45x39 7N39 ammo pack	30_pcs._5.45x39_7n39_ammo_pack
30 pcs. 5.45x39 PP gs ammo pack	30_pcs._5.45x39_pp_gs_ammo_pack
30 pcs. 5.45x39 PRS gs ammo pack	30_pcs._5.45x39_prs_gs_ammo_pack
30 pcs. 5.45x39 PS gs ammo pack	30_pcs._5.45x39_ps_gs_ammo_pack
5 pcs. 12x70 DIPP ammo box	5_pcs._12x70_dipp_ammo_box
7.62x39 PS ammo package	7.62x39_ps_ammo_package
7.62x54 R SNB ammo	7.62x54_r_snb_ammo
8 pcs pack of 9x39 7N12 BP ammo	8_pcs_pack_of_9x39_7n12_bp_ammo
8 pcs pack of 9x39 7N9 SPP ammo	8_pcs_pack_of_9x39_7n9_spp_ammo
MOE Carbine stock	moe_carbine_stock_fg
MOE Carbine stock	moe_carbine_stock_fde
MOE Carbine stock	moe_carbine_stock_sg
MOE Carbine stock	moe_carbine_stock_od
Object 21WS keycard	object_21ws_keycard
Object 11SR keycard	object_11sr_keycard
16 pcs. 9x19 Pst Gzh ammo box	16_pcs._9x19_pst_gzh_ammo_box
5.56x45 M193 Ball ammo	5.56x45_m193_ball_ammo
Grenade case	grenade_case
Aramid fiber cloth	aramid_fiber_cloth
Ripstop cloth	ripstop_cloth
Fleece cloth	fleece_cloth
Polyamide fabric Cordura	polyamide_fabric_cordura
SurvL Survivor Lighter	survl_survivor_lighter
Hunter matches	hunter_matches
KEKTAPE duct tape	kektape_duct_tape
Tube of Poxeram Cold Welding	tube_of_poxeram_cold_welding
Smoked Chimney drain cleaner	smoked_chimney_drain_cleaner
Pack of chlorine	pack_of_chlorine
Repellent	repellent
Cyclon accumulator battery	cyclon_accumulator_battery
GreenBat lithium battery	greenbat_lithium_battery
UZRGM grenade fuze	uzgrm_grenade_fuze
VOG-17 Khattabka grenade	vog-17_khattabka_grenade
VOG-25 Khattabka grenade	vog-25_khattabka_grenade
LBT 6094A Slick Plate Carrier	lbt_6094a_slick_plate_carrier
LBT-2670 Slim Field Med Pack	lbt-2670_slim_field_med_pack
Walker's Razor Digital headset	walker's_razor_digital_headset
MSA Gallet TC 800 High Cut combat helmet	msa_gallet_tc_800_high_cut_combat_helmet
Ars Arma CPC MOD.2 plate carrier	ars_arma_cpc_mod.2_plate_carrier
Spiritus Systems Bank Robber Chest Rig	spiritus_systems_bank_robber_chest_rig
Splav Tarzan M22 Rig	splav_tarzan_m22_rig
Pestily plague mask	pestily_plague_mask
CAA DRG L-1 mount for SVD	caa_drg_l-1_mount_for_svd
ULTRA medical storage key	ultra_medical_storage_key
Raven figurine	raven_figurine
Shroud half-mask	shroud_half-mask
Dollars	dollars
Euros	euros
Can of Dr. Lupo's coffee beans	can_of_dr._lupo's_coffee_beans
Special Twitch Rivals 2020 mask	special_twitch_rivals_2020_mask
Special Twitch Rivals 2020 half mask	special_twitch_rivals_2020_half_mask
Special Twitch Rivals 2020 glasses	special_twitch_rivals_2020_glasses
Submachinegun PPSH-41 7.62x25	submachinegun_ppsh-41_7.62x25
Colt M1911A1 .45 ACP pistol	colt_m1911a1_.45_acp_pistol
10.6" barrel for PPSH-41 7.62x25	10.6_barrel_for_ppsh-41_7.62x25
Standart barrel for M1911A1 .45 ACP	standart_barrel_for_m1911a1_.45_acp
35-round 7.62x25 magazine for PPSH-41	35-round_7.62x25_magazine_for_ppsh-41
M1911 .45 ACP 7-round magazine	m1911_.45_acp_7-round_magazine
71-round 7.62x25 magazine for PPSH-41	71-round_7.62x25_magazine_for_ppsh-41
PPSH-41 dust cover	ppsh-41_dust_cover
M1911A1 .45 ACP slide	m1911a1_.45_acp_slide
PPSH-41 stock	ppsh-41_stock
Standart polymerpistol grip for M1911A1	standart_polymerpistol_grip_for_m1911a1
Slide lock for M1911A1	catch_lever_for_m1911a1
Hammer for M1911A1	hammer_for_m1911a1
Trigger for M1911A1	trigger_for_m1911a1
M1911A1 Front Sight	m1911a1_front_sight
M1911A1 Rear Sight	m1911a1_rear_sight
FORT Defender-2 body armor	fort_defender-2_body_armor
Tac-Kek Fast MT Helmet (non-ballistic replica)	tac-kek_fast_mt_helmet_(non-ballistic_replica)
Tac-Kek Heavy Trooper mask	tac-kek_heavy_trooper_mask
LBT-8005A Day Pack backpack	lbt-8005a_day_pack_backpack
LBT-1961A Load Bearing Chest Vest	lbt-1961a_load_bearing_chest_vest
Midwest 14 inch M-LOK foregrip for MPX	midwest_14_inch_m-lok_foregrip_for_mpx
Hexagon "DTKP MK.2" 7.62x39 sound suppressor	hexagon_dtkp_mk.2_7.62x39_sound_suppressor
30 pcs. 5.45x39 BP gs ammo pack	30_pcs._5.45x39_bp_gs_ammo_pack
30 pcs. 5.45x39 BT gs ammo pack	30_pcs._5.45x39_bt_gs_ammo_pack
20 pcs. 9x19 mm DIPP ammo box	20_pcs._9x19_mm_dipp_ammo_box
Secure container Beta	secure_container_beta
RB-RLSSA key	rb-rlssa
RB-PKPM key	rb-pkpm_key
.45 ACP FMJ	.45_acp_fmj
.45 RIP	.45_rip
Surefire SOCOM556-RC2 5.56x45 silencer	surefire_socom556-rc2_5.56x45_silencer
CAA XRS DRG for SVD	caa_xrs_drg_for_svd
Geissele SMR Mk.16 9.5 inch M-LOK handguard for AR-15	geissele_smr_mk.16_9.5_inch_m-lok_handguard_for_ar-15
Geissele SMR Mk.16 13.5 inch M-LOK handguard for AR-15	geissele_smr_mk.16_13.5_inch_m-lok_handguard_for_ar-15
Izhmash modern handguard for SVD	izhmash_modern_handguard_for_svd
SilencerCo choke adapter for 12ga shotguns	silencerco_choke_adapter_for_12ga_shotguns
CAA XD RGL mount for SVD	caa_xd_rgl_mount_for_svd
Geissele ACH charging handle for AR-15	geissele_ach_charging_handle_for_ar-15
Raptor charging handle for AR-15 Grey	raptor_charging_handle_for_ar-15_grey
Polymer AK-74 foregrip (6P20 Sb.9) Plum	polymer_ak-74_foregrip_(6p20_sb.9)_plum
Strike Industries Viper carbine length M-LOK foregrip (FDE) for AR-15	strike_industries_viper_carbine_length_m-lok_foregrip_(fde)_for_ar-15
KGB MG-47 pistol grip for AK red	kgb_mg-47_pistol_grip_for_ak_red
Hexagon "Kocherga" stock red	hexagon_kocherga_stock_red
Magpul PRS GEN3 Grey stock	magpul_prs_gen3_grey_stock
Izhmash polymer Plum AK-74 stock (6P20 Sb.7)	izhmash_polymer_plum_ak-74_stock_(6p20_sb.7)
Magpul CTR Carbine stock FDE	magpul_ctr_carbine_stock_fde
Short length rail for Hexagon(Anodized Red)	short_length_rail_for_hexagon(anodized_red)
IzhMash modern rail for SVD	izhmash_modern_rail_for_svd
Surefire FH556RC 5.56x45 Flash hider for AR-15	surefire_fh556rc_5.56x45_flash_hider_for_ar-15
CNC Warrior AK 5.56x45 mm muzzle device adapter	cnc_warrior_ak_5.56x45_mm_muzzle_device_adapter
Additional armor for the Bastion helmet	additional_armor_for_the_bastion_helmet
Diamond Age Bastion Helmet	diamond_age_bastion_helmet
Upper receiver B&T 9x19 for MP9 SMG	upper_receiver_b&t_9x19_for_mp9_smg
3.1 FDE	kac_long_panel_for_urx_3_3.1_fde
FN GL40 Mk.2 grenade launcher	fn_gl40_mk.2_grenade_launcher
M.U.L.E. stimulator	m.u.l.e._stimulator
Cocktail "Obdolbos"	cocktail_obdolbos
P22	p22
L1 (Norepinephrine)	l1_(norepinephrine)
3-(b-TG)	3-(b-tg)
AHF1-M	ahf1-m
Meldonin	meldonin
.45 ACP AP	.45_acp_ap
.45 ACP Hydra-Shok	.45_acp_hydra-shok
.45 ACP Lasermatch FMJ	.45_acp_lasermatch_fmj
.366 AP	.366_ap
40x46 mm M381 (HE)	40x46_mm_m381_(he)
40x46 mm M386(HE)	40x46_mm_m386(he)
40x46 mm M406 (HE)	40x46_mm_m406_(he)
40x46 mm M433 (HEDP)	40x46_mm_m433_(hedp)
40x46 mm M441(HE)	40x46_mm_m441(he)
40x46 mm M576(MP-APERS)	40x46_mm_m576(mp-apers)
7.62x51 mm M993	7.62x51_mm_m993
9x19 mm 7N31	9x19_mm_7n31
9x19 mm QuakeMaker	9x19_mm_quakemaker
Key with tape	key_with_tape
Key card with a blue marking	key_card_with_a_blue_marking
Sanitar bag	sanitar_bag
30 pcs. 5.45x39 BS gs ammo pack	30_pcs._5.45x39_bs_gs_ammo_pack
Secure container Gamma	secure_container_gamma
Secure container Alpha	secure_container_alpha
Secure container Epsilon	secure_container_epsilon
Secure container Kappa	secure_container_kappa
GP-34 underbarrel grenade launcher	gp-34_underbarrel_grenade_launcher
LK 3F Transfer tourist backpack	lk_3f_transfer_tourist_backpack
Eberlestock F5 Switchblade backpack (dry earth)	eberlestock_f5_switchblade_backpack_(dry_earth)
Eberlestock F4 Terminator load bearing backpack (tiger stripe)	eberlestock_f4_terminator_load_bearing_backpack_(tiger_stripe)
Spiritus Systems Bank Robber Chest Rig	direct_action_thunderbolt_compact_chest_rig
Kel-Tec RFB 7.62x51	kel-tec_rfb_7.62x51_not_func
Colt M45A1 .45 ACP pistol	colt_m45a1_.45_acp_pistol
Mossberg 590A1 12ga shotgun	mossberg_590a1_12ga_shotgun
TOZ KS-23M 23x75mm shotgun	toz_ks-23m_23x75mm_shotgun
EYE MK.2 professional hand-held compass	eye_mk.2_professional_hand-held_compass
Premium Kvass "Norvinskiy Yadreniy" 0.6L bottle	premium_kvass_norvinskiy_yadreniy_0.6l_bottle
BNTI Korund-VM armor	bnti_korund-vm_armor
Rys-T helmet	rys-t_helmet
Headwear	galvion_caiman_ballistic_helmet
30x29 mm VOG-30	30x29_mm_vog-30
23x75mm "Barricade"	barricade
23x75mm Shrapnel 10	23x75mm_shrapnel_10
23x75mm Shrapnel-25	23x75mm_shrapnel-25
23x75mm "Star"	23x75mm_star
Esmarch tourniquet	esmarch_tourniquet
CALOK-B Hemostatic	calok-b_hemostatic
Rotor 43 7.62x51 muzzle brake for VPO-101	rotor_43_7.62x51_muzzle_brake_for_vpo-101
Headsets	walker's_xcel_500bt_digital_headset
Caiman Hybrid Ballistic Applique (black)	caiman_hybrid_ballistic_applique_(black)
Caiman Fixed Arm Visor	caiman_fixed_arm_visor
Caiman Ballistic Guard Mandible	caiman_ballistic_guard_mandible
Rys-T face shield	rys-t_face_shield
X47 Tactical Handguard for AK and compatible	x47_tactical_handguard_for_ak_and_compatible
Daniel Defence RIS II 9.5 foregrip for AR-15-compatible systems	daniel_defence_ris_ii_9.5_fde_foregrip_for_ar-15-compatible_systems
B-30 foregrip and rail mount B-31С	b-30_foregrip_and_rail_mount_b-31с
M45A1 .45 ACP slide	m45a1_.45_acp_slide
Black beret	black_beret
Blue beret	blue_beret
Olive beret	olive_beret
Desert Tech foregrip for MDR	desert_tech_foregrip_for_mdr_blk
Magpul MOE M590 forestock	magpul_moe_m590_forestock
Zenit B-33 dust cover for AK-74	ultimak_m1-b_handguard_for_ak
TOZ KS-23M forestock	toz_ks-23m_forestock
Kel-Tec RFB regular handguard	kel-tec_rfb_regular_handguard
SOK-12 aluminum handguard Bravo-18	sok-12_aluminum_handguard_bravo-18
Speedfeed short M590A1 forestock	speedfeed_short_m590a1_forestock
Lancer LCH-7 12.5 inch M-LOK handguard for AR-10	lancer_lch-7_12.5_inch_m-lok_handguard_for_ar-10
Veritas guitar pick	veritas_guitar_pick
TD Aluminium skeletonized vertical grip	td_aluminium_skeletonized_vertical_grip
JMAC RRD-4C 7.62x39 muzzle brake for AKM type thread	jmac_rrd-4c_7.62x39_muzzle_brake_for_akm_type_thread
JMAC RRD-4C muzzle brake for AK-74 type thread	jmac_rrd-4c_muzzle_brake_for_ak-74_type_thread
Regular RFB 7.62x51 Flash hider	regular_rfb_7.62x51_flash_hider
Anarchy Outdoors Muzzle Brake .45 ACP	anarchy_outdoors_muzzle_brake_.45_acp
Ferfrans "CRD" 5.56x45	ferfrans_crd_5.56x45
Ferfrans Muzzle Brake 5.56x45	ferfrans_muzzle_brake_5.56x45
M700 thread protection cap	m700_thread_protection_cap_2
RFB Thread spacer	rfb_thread_spacer
RFB thread protection cap	rfb_thread_protection_cap
Ghost ring kit M590 Frontsight	ghost_ring_kit_m590_frontsight
Ghost ring Rear sight for M590	ghost_ring_rear_sight_for_m590
Novak Lomount Front Sight	novak_lomount_front_sight
Novak Lomount Rear Sight	novak_lomount_rear_sight
Wilson Extended slide stop for M1911A1	wilson_extended_slide_stop_for_m1911a1
STI HEX Hammer for M1911A1	sti_hex_hammer_for_m1911a1
Hammer for M1911A1	hammer_for_m1911a1_wilson_retro_commander
Wilson Ultralight skeletonized hammer for M1911A1	wilson_ultralight_skeletonized_hammer_for_m1911a1
Caspian Trik Trigger for M1911A1	caspian_trik_trigger_for_m1911a1
Slide lock for M45A1	slide_lock_for_m45a1
Hammer for M45A1	hammer_for_m45a1
Trigger for M45A1	trigger_for_m45a1
Avalanche Mod.2 charging handle for AR-15	avalanche_mod.2_charging_handle_for_ar-15
MP-153 forend cap	мp-153_forend_cap
30-round 6L23 5.45x39 magazine for AK-74 and compatibles	30-round_6l23_plum_5.45x39_magazine_for_ак-74_and_compatibles
3-shell KS-23M 23mm magazine cap	3-shell_ks-23m_23mm_magazine_cap
Palm US AK30 7.62x39 magazine for AK and compatibles, 30-round capacity	palm_us_ak30_7.62x39_magazine_for_ak_and_compatibles,_30-round_capacity_(fde)
PMAG GEN M3 30 5.56x45 STANAG 30-round magazine	pmag_gen_m3_30_5.56x45_stanag_30-round_magazine_fde
AKM GEN M3 7.62x39 magazine for AK and compatibles, 30-round capacity	pmag_30_ak_akm_gen_m3_7.62x39_magazine_for_ak_and_compatibles,_30-round_capacity_(banana)
8-shell M590A1 12ga magazine cap	8-shell_m590a1_12ga_magazine_cap
M45A1 .45 ACP 7-round magazine	m45a1_.45_acp_7-round_magazine
100 rounds belt	100_rounds_belt
Mec-Gar .45 ACP 11-round magazine for M1911A1	mec-gar_.45_acp_11-round_magazine_for_m1911a1
Black Aces Tactical RB7M rail for M590	black_aces_tactical_rb7m_rail_for_m590
Ops Core Picatinny Rail Adapter mount	ops_core_picatinny_rail_adapter_mount
Ops Core Single Clamp Rail Adapter mount	ops_core_single_clamp_rail_adapter_mount
Kel-Tec RFB scope mount rail	kel-tec_rfb_scope_mount_rail
Weigand Weig-a-tinny mount for M1911A1	weigand_weig-a-tinny_mount_for_m1911a1
NCStar Trigger guard mount for M1911A1	ncstar_trigger_guard_mount_for_m1911a1
Kel-Tec RFB handguard rail	kel-tec_rfb_handguard_rail
SGA stock for M590	sga_stock_for_m590
Wired stock for KS-23M	wired_stock_for_ks-23m
Wooden stock for KS-23	wooden_stock_for_ks-23
Polymer stock for M590A1	polymer_stock_for_m590a1
Mesa Tactical Crosshair Hydraulic buffer tube	mesa_tactical_crosshair_hydraulic_buffer_tube
LEO stock adapter gen.1 for M590	leo_stock_adapter_gen.1_for_m590
VPO-101 SVD style stock	vpo-101_svd_style_stock
510mm barrel for KS-23 23x75mm	510mm_barrel_for_ks-23_23x75mm
700mm barrel for KS-23 23x75mm	700mm_barrel_for_ks-23_23x75mm
18" barrel for RFB 7.62x51	18_barrel_for_rfb_7.62x51
20" barrel for M590 12ga	20_barrel_for_m590_12ga
Threaded barrel for M1911A1 .45 ACP	threaded_barrel_for_m1911a1_.45_acp
National match barrel for M1911 .45 ACP	national_match_barrel_for_m1911_.45_acp
6B43 Zabralo-Sh 6A Armor	6b43_zabralo-sh_6a_armor
Expeditionary fuel tank	expeditionary_fuel_tank
Aeroknox scorpius pistol grip for AK	aeroknox_scorpius_pistol_grip_for_ak
Sig Sauer pistol grip for P226	sig_sauer_fde_pistol_grip_for_p226_(combat)
Pachmayr "American legend grip 423 for M1911A1	pachmayr_american_legend_grip_#423_for_m1911a1
Polymer pistol grip for KS-23M	polymer_pistol_grip_for_ks-23m
Standart polymerpistol grip for M45A1	standart_polymerpistol_grip_for_m45a1
Highcom Trooper TFO armor (multicam)	highcom_trooper_tfo_armor_(multicam)_(0_70)
Lone Star TX-15 DML Rifle	lone_star_tx-15_dml_rifle
ADAR 2-15 .223 Carbine	adar_2-15_.223_carbine
DS Arms SA-58 7.62x51	ds_arms_sa-58_7.62x51
DT MDR 5.56x45 Assault Rifle	dt_mdr_5.56x45_assault_rifle
DT MDR 7.62x51 Assault Rifle	dt_mdr_7.62x51_assault_rifle
Colt M4A1 5.56x45 Assault Rifle	colt_m4a1_5.56x45_assault_rifle
Kel-Tec RFB 7.62x51	kel-tec_rfb_7.62x51
TDI Kriss Vector Gen.2 9x19 submachinegun	tdi_kriss_vector_gen.2_9x19_submachinegun
TDI KRISS Vector Gen.2 .45 ACP submachinegun	tdi_kriss_vector_gen.2_.45_acp_submachinegun
HK UMP 45 submachinegun	hk_ump_45_submachinegun
DIY IDEA chest rig	diy_idea_chest_rig
Security vest	security_vest
Gear Craft GC-BSS-MK1 rig	gear_craft_gc-bss-mk1_rig
SIG MCX .300 AAC Blackout Assault Rifle	sig_mcx_.300_aac_blackout_assault_rifle
Mk-18 .338 LM marksman rifle	mk-18_.338_lm_marksman_rifle
.300 BPZ AAC Blackout	.300_bpz_aac_blackout
.300 AAC Blackout AP	.300_aac_blackout_ap
.338 Lapua Magnum AP	.338_lapua_magnum_ap
.338 Lapua Magnum FMJ	.338_lapua_magnum_fmj
.338 UPZ Lapua Magnum	.338_upz_lapua_magnum
.338 Lapua Magnum TAC-X	.338_lapua_magnum_tac-x
5.11 Hexgrid plate carrier	5.11_hexgrid_plate_carrier
SilencerCo Omega 45k .45 ACP sound suppressor	silencerco_omega_45k_.45_acp_sound_suppressor
Sig-Sauer "SRD" 7.62x51 Sound Suppressor	sig-sauer_srd_7.62x51_sound_suppressor
Sig-Sauer SRD QD 7.62x51 Sound Suppressor	sig-sauer_srd_qd_7.62x51_sound_suppressor
SIG MCX Flip Up sight Rearsight	sig_mcx_flip_up_sight_rearsight
Cultist's knife	cultist's_knife
Antidote xTG-12	antidote_xtg-12
Combat stimulant injector SJ9 TGLabs	combat_stimulant_injector_sj9_tglabs
Magpul RVG grip FDE	magpul_rvg_grip_fde
MVF001 A3 Vertical Grip KeyMod black	mvf001_a3_vertical_grip_keymod_black
Sig Sauer Vertical Foregrip Keymod Black	sig_sauer_vertical_foregrip_keymod_black
SIG MCX Gas Block	sig_mcx_gas_block
Mk-18 Gas Block	mk-18_gas_block
3-prong SIG Flash hider 7.62x51	3-prong_sig_flash_hider_7.62x51
SIG micro brake muzzle brake 7.62x51	sig_micro_brake_muzzle_brake_7.62x51
Kriss Vector .45 ACP Flash hider	kriss_vector_.45_acp_flash_hider
SilencerCo AC-858 ASR .338 LM Muzzle brake	silencerco_ac-858_asr_.338_lm_muzzle_brake
KRISS Vector 9x19 Flash hider	kriss_vector_9x19_flash_hider
SIG Two Port brake muzzle brake 7.62x51	sig_two_port_brake_muzzle_brake_7.62x51
SIG Taper-LOK Muzzle Adapter	sig_taper-lok_muzzle_adapter
Vector 9x19 thread protection cap	vector_9x19_thread_protection_cap
Direct Thread Mount adapter for Silencerco Omega 45k	direct_thread_mount_adapter_for_silencerco_omega_45k
Piston Mount adapter for Silencerco Omega 45k	piston_mount_adapter_for_silencerco_omega_45k
Kriss Vector .45 ACP thread protection cap	kriss_vector_.45_acp__thread_protection_cap
SIG MCX Folding sight Frontsight	sig_mcx_folding_sight_frontsight
Kriss "Defiance Low Profile Flip Up" Frontsight	kriss_defiance_low_profile_flip_up_frontsight
KRISS Defiance Low Profile Flip-Up rear sight	kriss_defiance_low_profile_flip-up_rear_sight
Sig-Sauer charging handle for MCX	sig-sauer_charging_handle_for_mcx
Magex G30 magazine for Glock .45 ACP	magex_g30_magazine_for_glock_.45_acp
Glock .45 ACP magazine	glock_.45_acp_magazine
Standard UMP 25-round .45 ACP magazine	standard_ump_25-round_.45_acp_magazine
Sword Int. Mk-18 .338 LM 10-round magazine	sword_int._mk-18_.338_lm_10-round_magazine
KRISS Vector Bottom rail	kriss_vector_bottom_rail
HK UMP Bottom rail	hk_ump_bottom_rail
KRISS Vector Side rail	kriss_vector_side_rail
KRISS Mk.5 Modular rail for Vector	kriss_mk.5_modular_rail_for_vector
HK UMP Side rail	hk_ump_side_rail
B5 Precision stock	b5_precision_stock
Polymer stock for UMP	polymer_stock_for_ump
KRISS Vector non folding stock adapter	kriss_vector_non_folding_stock_adapter
Kriss Vector Pistol Sling Adapter	kriss_vector_pistol_sling_adapter
KRISS Defiance DS150 stock	kriss_defiance_ds150_fde_stock
MPX stock	sig_sauer_thin_lightweight_mcx_mpx_stock
KRISS Defiance DS150 stock	kriss_defiance_ds150_stock
KRISSVector Gen.2 folding stock	krissvector_gen.2_folding_stock
MPX stock	sig_sauer_telescoping_mcx_mpx_stock
171mm barrel for MCX and compatible .300 BLK	171mm_barrel_for_mcx_and_compatible_.300_blk
229mm barrel for MCX and compatible .300 BLK	229mm_barrel_for_mcx_and_compatible_.300_blk
24" barrel for Mk-18 .338 LM	24_barrel_for_mk-18_.338_lm
5" barrel for Vector 9x19	5_barrel_for_vector_9x19
6" Vector barrel .45 ACP	6_vector_barrel_.45_acp
8" barrel for UMP .45 ACP	8_barrel_for_ump_.45_acp
5" Vector barrel .45 ACP	5_vector_barrel_.45_acp
6" barrel for Vector 9x19	6_barrel_for_vector_9x19
SIG 12" keymod foregrip for MCX	sig_12_keymod_foregrip_for_mcx
Sword int. 18 inch handguard for Mk-18	sword_int._18_inch_handguard_for_mk-18
SIG 8" keymod foregrip for MCX	sig_8_keymod_foregrip_for_mcx
SIG MCX pistol grip	sig_mcx_pistol_grip
Upper receiver of the first generation Sig-Sauer MCX	upper_receiver_of_the_first_generation_sig-sauer_mcx
Sword Int. Mk-18 mod 1 Upper receiver	sword_int._mk-18_mod_1_upper_receiver
Smoke balaclava	smoke_balaclava
30 pcs. 5.45x39 T gs ammo pack	30_pcs._5.45x39_t_gs_ammo_pack
16 pcs. 9x18 PM P gzh ammo box	16_pcs._9x18_pm_p_gzh_ammo_box
16 pcs. 9x18 PM PSO gzh ammo box	16_pcs._9x18_pm_pso_gzh_ammo_box
16 pcs. 9x18 PM PRS gs ammo box	16_pcs._9x18_pm_prs_gs_ammo_box
16 pcs. 9x18 PM PSV ammo box	16_pcs._9x18_pm_psv_ammo_box
16 pcs. 9x18 PM RG028 gzh ammo box	16_pcs._9x18_pm_rg028_gzh_ammo_box
120 pcs. 5.45x39 PS gs ammo pack	120_pcs._5.45x39_ps_gs_ammo_pack
16 pcs. 9x18 PM PPT gzh ammo box	16_pcs._9x18_pm_ppt_gzh_ammo_box
30 pcs. 5.45x39 US gs ammo pack	30_pcs._5.45x39_us_gs_ammo_pack
30 pcs. 5.45x39 FMJ ammo box	30_pcs._5.45x39_fmj_ammo_box
30 pcs. 5.45x39 HP ammo box	30_pcs._5.45x39_hp_ammo_box
120 pcs. 5.45x39 T gs ammo pack	120_pcs._5.45x39_t_gs_ammo_pack
30 pcs. 5.45x39 SP ammo box	30_pcs._5.45x39_sp_ammo_box
120 pcs. 5.45x39 BP gs ammo pack	120_pcs._5.45x39_bp_gs_ammo_pack
120 pcs. 5.45x39 BS gs ammo pack	120_pcs._5.45x39_bs_gs_ammo_pack
120 pcs. 5.45x39 BP gs ammo pack	120_pcs._5.45x39_bp_gs_ammo_pack_2
120 pcs. 5.45x39 BS gs ammo pack	120_pcs._5.45x39_bs_gs_ammo_pack_2
120 pcs. 5.45x39 T gs ammo pack	120_pcs._5.45x39_t_gs_ammo_pack_2
120 pcs. 5.45x39 BT gs ammo pack	120_pcs._5.45x39_bt_gs_ammo_pack_2
120 pcs. 5.45x39 PRS gs ammo pack	120_pcs._5.45x39_prs_gs_ammo_pack_2
16 pcs. 9x18 PM PS gs PPO ammo box	16_pcs._9x18_pm_ps_gs_ppo_ammo_box
120 pcs. 5.45x39 PP gs ammo pack	120_pcs._5.45x39_pp_gs_ammo_pack
120 pcs. 5.45x39 PS gs ammo pack	120_pcs._5.45x39_ps_gs_ammo_pack_2
120 pcs. 5.45x39 US gs ammo pack	120_pcs._5.45x39_us_gs_ammo_pack_2
Rivals 2020 armband	rivals_2020_armband
Rivals 2020 cap	rivals_2020_cap
Rivals 2020 beanie	rivals_2020_beanie
Roubles	roubles
Metal fuel tank	metal_fuel_tank_(0_100)
MF-UNTAR armor vest	mf-untar_armor_vest_(0_45)
Altyn face shield	altyn_face_shield_damaged
BNTI Gzhel-K armor	bnti_gzhel-k_armor_0_65
TP-200 TNT brick	tp-200_tnt_brick
Can of thermite	can_of_thermite
Ratchet wrench	ratchet_wrench
STM-9 9x19 muzzle brake	stm-9_9x19_muzzle_brake
PL-15 9x19mm sound suppressor	pl-15_9x19mm_sound_suppressor
Eberlestock G2 Gunslinger II backpack (dry earth)	eberlestock_g2_gunslinger_ii_backpack_(dry_earth)
Hazard4 Takedown sling backpack	hazard4_takedown_sling_backpack_(multicam)
Hazard4 Takedown sling backpack	hazard4_takedown_sling_backpack
Azimut SS Jhuk Chest Harness	azimut_ss_jhuk_chest_harness_(black)
CSA chest rig	csa_chest_rig
Umka М33-SET1 hunter's vest	umka_м33-set1_hunter's_vest
Azimut SS Jhuk Chest Harness	azimut_ss_jhuk_chest_harness_(surpat)
PL-15 9x19 pistol	pl-15_9x19_pistol
STM-9 Gen.2 9x19 carabine	stm-9_gen.2_9x19_carabine
LBT 6094A Slick Plate Carrier	lbt_6094a_slick_plate_carrier_(olive)
LBT 6094A Slick Plate Carrier	lbt_6094a_slick_plate_carrier_(tan)
Opsmen Earmor M32 headset	opsmen_earmor_m32_headset
Hemostatic tourniquet CAT	hemostatic_tourniquet_cat
AFAK personal tactical first aid kit	afak_personal_tactical_first_aid_kit
Emergency water ration	emergency_water_ration
UVSR Taiga-1	uvsr_taiga-1
GP-7 gasmask	gp-7_gasmask
Army cap	black_army_cap
Army cap	coyote_army_cap
Army cap	cadpat_army_cap
Army cap	flora_army_cap
Army cap	desert_army_cap
Army cap	ucp_army_cap
NPP KlASS Condor glasses	npp_klass_condor_glasses
5.56x45 mm Mk 318 Mod 0 (SOST)	5.56x45_mm_mk_318_mod_0_(sost)
5.56x45 mm SSA AP	5.56x45_mm_ssa_ap
7.62x39 mm MAI AP	7.62x39_mm_mai_ap
PL-15 Standard Frontsight	pl-15_standard_frontsight
PL-15 extended front sight	pl-15_extended_front_sight
PL-15 Standard Rear-sight	pl-15_standard_rear-sight
PL-15 extended rear sight	pl-15_extended_rear_sight
Magwell STM-9	magwell_stm-9
Magwell STM-9 Grey	magwell_stm-9_grey
MASP Ambi battle charging handle for AR-15	masp_ambi_battle_charging_handle_for_ar-15
PL-15 9x19 magazine, 16-round capacity	pl-15_9x19_magazine,_16-round_capacity
STM Arms buffer tube	stm_arms_buffer_tube
Fab Defence GL Core Stock	fab_defence_gl_core_stock
Regular barrel for PL-15 9x19	regular_barrel_for_pl-15_9x19
10.5" barrel for STM-9 9x19	10.5_barrel_for_stm-9_9x19
Threaded barrel for PL-15	threaded_barrel_for_pl-15
12" barrel for STM-9 9x19	12_barrel_for_stm-9_9x19
14" barrel for STM-9 9x19	14_barrel_for_stm-9_9x19
16" barrel for STM-9 9x19	16_barrel_for_stm-9_9x19
STM 12 inch M-LOK handguard for AR-15	stm_12_inch_m-lok_handguard_for_ar-15
STM 15 inch M-LOK handguard for AR-15	stm_15_inch_m-lok_handguard_for_ar-15
STM 9 inch M-LOK handguard for AR-15	stm_9_inch_m-lok_handguard_for_ar-15
DLG-123 pistol grip for AR-15 based systems	dlg-123_pistol_grip_for_ar-15_based_systems
PL-15 pistol slide	pl-15_pistol_slide
Upper receiver for STM-9 9x19 carbine	upper_receiver_for_stm-9_9x19_carbine
 VPO-209 366TKM carbine	vepr_akm___vpo-209_366tkm_carbine_not_func
Simonov Semi-Automatic Carbine SKS 7.62x39 Hunting Rifle Version	simonov_semi-automatic_carbine_sks_7.62x39_hunting_rifle_version_not_func
Simonov Semi-Automatic Carbine SKS 7.62x39	simonov_semi-automatic_carbine_sks_7.62x39_not_func
 VPO-136 7.62x39 carbine	vepr_km___vpo-136_7.62x39_carbine_not_func
VPO-101 7.62x51 carbine	vepr_hunter_vpo-101_7.62x51_carbine_not_func
AK-102 5.56x45 assault rifle	ak-102_5.56x45_assault_rifle_not_func
AK-74N 5.45x39 assault rifle	ak-74n_5.45x39_assault_rifle_not_func
AKS-74N 5.45x39 assault rifle	aks-74n_5.45x39_assault_rifle_not_func
AK-104 7.62x39 assault rifle	ak-104_7.62x39_assault_rifle_not_func
HK 416A5 5.56x45 Assault Rifle	hk_416a5_5.56x45_assault_rifle_not_func
SIG MCX .300 AAC Blackout Assault Rifle	sig_mcx_.300_aac_blackout_assault_rifle_not_func
AK-105 5.45x39 assault rifle	ak-105_5.45x39_assault_rifle_not_func
ASh-12 12.7x55 assault rifle	ash-12_12.7x55_assault_rifle_not_func
AK-103 7.62x39 assault rifle	ak-103_7.62x39_assault_rifle_not_func
Kalashnikov AKS-74U 5.45x39	kalashnikov_aks-74u_5.45x39_not_func
Kalashnikov AKS-74UB 5.45x39	kalashnikov_aks-74ub_5.45x39_not_func
AK-74 5.45x39 assault rifle	ak-74_5.45x39_assault_rifle_not_func
AKM 7.62x39 assault rifle	akm_7.62x39_assault_rifle_not_func
AKMN 7.62x39 assault rifle	akmn_7.62x39_assault_rifle_not_func
AKMS 7.62x39 assault rifle	akms_7.62x39_assault_rifle_not_func
AK-101 5.56x45 assault rifle	ak-101_5.56x45_assault_rifle_not_func
AS VAL	as_val_not_func
AKMSN 7.62x39 assault rifle	akmsn_7.62x39_assault_rifle_not_func
Kalashnikov AKS-74UN 5.45x39	kalashnikov_aks-74un_5.45x39_not_func
AK-74M 5.45x39 assault rifle	ak-74m_5.45x39_assault_rifle_not_func
AKS-74 5.45x39 assault rifle	aks-74_5.45x39_assault_rifle_not_func
Mosin bolt-action infantry rifle	mosin_bolt-action_infantry_rifle_not_func
Remington Model 700 Sniper rifle	remington_model_700_sniper_rifle_not_func
Mosin bolt-action sniper rifle	mosin_bolt-action_sniper_rifle_not_func
Molot VPO-215 .366 TKM rifle	molot_vpo-215_.366_tkm_rifle_not_func
Orsis T-5000 .308 sniper rifle	orsis_t-5000_.308_sniper_rifle_not_func
DVL-10 Saboteur sniper rifle	dvl-10_saboteur_sniper_rifle_not_func
SV-98 bolt-action sniper rifle	sv-98_bolt-action_sniper_rifle_not_func
RPK-16 5.45x39 light machine gun	rpk-16_5.45x39_light_machine_gun_not_func
Knight's Armament Company SR-25 7.62x51	knight's_armament_company_sr-25_7.62x51_not_func
SVDS 7.62x54 Sniper rifle	svds_7.62x54_sniper_rifle_not_func
Springfield Armory M1A 7.62x51	springfield_armory_m1a_7.62x51_not_func
Remington R11 RSASS 7.62x51	remington_r11_rsass_7.62x51_not_func
Mk-18 .338 LM marksman rifle	mk-18_.338_lm_marksman_rifle_not_func
Special Sniper Rifle VSS Vintorez	special_sniper_rifle_vss_vintorez_not_func
PM (t) 9x18PM pistol	pm_(t)_9x18pm_pistol_not_func
P226R 9x19 pistol	p226r_9x19_pistol_not_func
Silenced Stechkin Automatic Pistol 9x18PM	silenced_stechkin_automatic_pistol_9x18pm_not_func
Colt M45A1 .45 ACP pistol	colt_m45a1_.45_acp_pistol_not_func
FN Five-seveN MK2 5.7x28 pistol	fn_five-seven_mk2_5.7x28_pistol_not_func
TT pistol 7.62x25 TT Gold	tt_pistol_7.62x25_tt_gold_not_func
FN Five-seveN MK2 5.7x28 pistol	fn_five-seven_mk2_fde_frame_5.7x28_pistol_not_func
Beretta M9A3 9x19 pistol	beretta_m9a3_9x19_pistol_not_func
TT pistol 7.62x25 TT	tt_pistol_7.62x25_tt_not_func
PB 9x18PM silenced pistol	pb_9x18pm_silenced_pistol_not_func
Colt M1911A1 .45 ACP pistol	colt_m1911a1_.45_acp_pistol_not_func
PM 9x18PM pistol	pm_9x18pm_pistol_not_func
Stechkin Automatic Pistol 9x18PM	stechkin_automatic_pistol_9x18pm_not_func
PL-15 9x19 pistol	pl-15_9x19_pistol_not_func
Yarygin MP-443 Grach 9x19 pistol	yarygin_mp-443_grach_9x19_pistol_not_func
GLOCK 18C 9x19 pistol	glock_18c_9x19_pistol_not_func
GLOCK 17 9x19 pistol	glock_17_9x19_pistol_not_func
9x21 Serdyukov automatic pistol SR1MP Gyurza	9x21_serdyukov_automatic_pistol_sr1mp_gyurza_not_func
TOZ-106 bolt-action shotgun	toz-106_bolt-action_shotgun_not_func
Mossberg 590A1 12ga shotgun	mossberg_590a1_12ga_shotgun_not_func
Remington Model 870 12ga shotgun	remington_model_870_12ga_shotgun_not_func
MP-153 12ga semi-automatic shotgun	mp-153_12ga_semi-automatic_shotgun_not_func
MP-133 12ga shotgun	mp-133_12ga_shotgun_not_func
TOZ KS-23M 23x75mm shotgun	toz_ks-23m_23x75mm_shotgun_not_func
76 shotgun	saiga_12ga_ver._10_12_76_shotgun_not_func
B&T MP9 9x19 submachinegun	b&t_mp9_9x19_submachinegun_not_func
Submachinegun PP-19-01 Vityaz-SN 9x19	submachinegun_pp-19-01_vityaz-sn_9x19_not_func
FN P90 5.7x28 submachinegun	fn_p90_5.7x28_submachinegun_not_func
HK MP7A2 4.6x30 submachinegun	hk_mp7a2_4.6x30_submachinegun_not_func
HK MP7A1 4.6x30 submachinegun	hk_mp7a1_4.6x30_submachinegun_not_func
B&T MP9-N 9x19 Submachinegun	b&t_mp9-n_9x19_submachinegun_not_func
STM-9 Gen.2 9x19 carabine	stm-9_gen.2_9x19_carabine_not_func
PP-91 Kedr 9x18PM SMG	pp-91_kedr_9x18pm_smg_not_func
HK UMP 45 submachinegun	hk_ump_45_submachinegun_not_func
HK MP5 9x19 submachinegun (Navy 3 Round Burst)	hk_mp5_9x19_submachinegun_(navy_3_round_burst)_not_func
SIG MPX 9x19 Submachine gun	sig_mpx_9x19_submachine_gun_not_func
PP-91-01 Kedr-B 9x18PM SMG	pp-91-01_kedr-b_9x18pm_smg_not_func
HK MP5 Kurz 9x19 submachinegun	hk_mp5_kurz_9x19_submachinegun_not_func
Saiga-9 9x19 Carbine	saiga-9_9x19_carbine_not_func
Submachinegun PPSH-41 7.62x25	submachinegun_ppsh-41_7.62x25_not_func
TDI KRISS Vector Gen.2 .45 ACP submachinegun	tdi_kriss_vector_gen.2_.45_acp_submachinegun_not_func
TDI Kriss Vector Gen.2 9x19 submachinegun	tdi_kriss_vector_gen.2_9x19_submachinegun_not_func
PP-9 Klin 9x18PMM SMG	pp-9_klin_9x18pmm_smg_not_func
FN GL40 Mk.2 grenade launcher	fn_gl40_mk.2_grenade_launcher_not_func
GP-34 underbarrel grenade launcher	gp-34_underbarrel_grenade_launcher_not_func
LVNDMARK's rat poison	lvndmark's_rat_poison
MK12 Low Profile Gas Block	cmmg_low_profile_gas_block
AAC Blackout 51T 5.56x45 flash-hider	silencerco_asr_51t_5.56x45_flash_hider
GK-02 Muzzle Brake	ar-10_cmmg_sv_brake_7.62x51_muzzle_brake
Zenit DTK-1 7.62x39 & 5.45x39 muzzle brake & compensator for AK	ar-10_surefire_procomp_7.62x51_muzzle_brake
AAC Blackout 51T 5.56x45 flash-hider	silencerco_saker_asr_556_5.56x45_sound_suppressor
VOMZ PILAD Target Ring reflex sight	vomz_pilad_target_ring_reflex_sight
Sig Sauer Romeo 4 reflex sight	sig_sauer_romeo8t_reflex_sight
Scav Raiders	valday_krechet_reflex_sight
Torrey Pines Logic T12W	torrey_pines_logic_t12w_thermal_reflex_sight
MP-155 Ultima thermal camera	mp-155_ultima_thermal_camera
mp-155 ultima underbarrel mount	mp-155_ultima_underbarrel_mount
mp-155 ultima pistol grip rubber pad	mp-155_ultima_pistol_grip_rubber_pad
KAC Ambidextrous Charging Handle for AR-10	mk47_ambidextrous_charging_handle
мp-155 6-round magazine extension	мp-155_6-round_magazine_extension
Axion Cobra mount	vpo-102_arbalet_mount
mp-155 ultima top rail	mp-155_ultima_top_rail
AKM 7.62x39 assault rifle	custom_guns_rail_guide
mp-155 ultima short rail	mp-155_ultima_short_rail
Weapons	cmmg_ripstock_buttstock
SI Advanced receiver extension buffer tube	cmmg_buffer_tube
mp-155 walnut stock	mp-155_walnut_stock
mp-155 ultima polymer stock	mp-155_ultima_polymer_stock
ProMag Archangel OPFOR PRS Mosin rifle stock	akm_ak-74_promag_archangel_opfor_aa47_buttstock
mp-155 ultima large recoil pad	mp-155_ultima_large_recoil_pad
mp-155 ultima medium recoil pad	mp-155_ultima_medium_recoil_pad
mp-155 ultima small recoil pad	mp-155_ultima_small_recoil_pad
MP-155 510mm barrel	mp-155_510mm_barrel
Weapons	mk47_254mm_barrel
Weapons	mk47_409mm_barrel
76 shotgun	sok-12_custom_guns_type-340_handguard
Weapon box (6x3)	ar-10_cmmg_mk3_rml15_15_inch_m-lok_handguard
Weapon box (6x3)	ar-10_cmmg_mk3_rml9_9_inch_m-lok_handguard
Barter trades	ar-15_unique-ars_wing_&_skull_12_inch_handguard
mp-155 walnut forestock	mp-155_walnut_forestock
mp-155 ultima polymer stock	mp-155_ultima_polymer_stock
Remington Model 700 Sniper rifle	ak_custom_arms_ags-74_pro_ _sniper_kit_pistol_grip
mp-155 ultima pistol grip	mp-155_ultima_pistol_grip
Scav Raiders	mk47_resolute_7.62x39_upper_receiver
Mystery Ranch Blackjack 50 backpack (multicam)	mystery_ranch_terraplane_backpack
Hazard4 Pillbox backpack	hazard4_pillbox_backpack
Hazard 4 Drawbridge backpack	hazard_4_drawbridge_backpack
Waist pouch	waist_pouch
Stich Profi Chest Rig MK2 (Recon, A-TACS FG)	stich_profi_chest_rig_mk2_(recon,_a-tacs_fg)
Stich Profi Chest Rig MK2 (Assault, A-TACS FG)	stich_profi_chest_rig_mk2_(assault,_a-tacs_fg)
Crye Precision AVS MBAV (Tagilla Edition)	crye_precision_avs_mbav_(tagilla_edition)
CQC Osprey MK4A plate carrier (Assault, MTP)	cqc_osprey_mk4a_plate_carrier_(assault,_mtp)
CQC Osprey MK4A plate carrier (Protection, MTP)	cqc_osprey_mk4a_plate_carrier_(protection,_mtp)
WZ Wallet	wz_wallet
Weapons	cmmg_mk47_mutant_7.62x39_assault_rifle
MP-155 12ga semi-automatic shotgun	mp-155_12ga_semi-automatic_shotgun
Evasion armband	evasion_armband
NFM THOR Concealable Vest body armor	nfm_thor_concealable_vest_body_armor
NFM THOR Concealable Vest body armor	nfm_thor_integrated_carrier_body_armor
Tagilla's welding mask "Gorilla"	tagilla's_welding_mask_gorilla
Tagilla's welding mask "UBEY"	tagilla's_welding_mask_ubey
Sanitar	boss_cap
Kotton beanie	bomber_beanie
Stich Profi Chimera boonie hat	stich_profi_chimera_boonie_hat
Can of RatCola	can_of_ratcola
Superfors DB 2020 Dead Blow Hammer	superfors_db_2020_dead_blow_hammer
Loot Lord plushie	loot_lord_plushie